rep	ct0	ct1	ct2	ct3	selected	convergent	rel_conv
1	1494	34	4	0	38	4	0.10526315789473684
10	1534	28	2	0	30	2	0.06666666666666667
100	1495	28	1	0	29	1	0.034482758620689655
1000	1529	29	0	0	29	0	0
10000	1516	17	2	0	19	2	0.10526315789473684
1001	1483	27	1	0	28	1	0.03571428571428571
1002	1528	31	0	0	31	0	0
1003	1536	25	0	0	25	0	0
1004	1490	24	1	0	25	1	0.04
1005	1518	32	0	0	32	0	0
1006	1522	30	0	0	30	0	0
1007	1527	31	1	0	32	1	0.03125
1008	1553	27	0	0	27	0	0
1009	1527	25	0	1	26	1	0.038461538461538464
101	1496	39	1	0	40	1	0.025
1010	1530	23	2	0	25	2	0.08
1011	1495	35	1	0	36	1	0.027777777777777776
1012	1480	23	2	0	25	2	0.08
1013	1512	43	0	0	43	0	0
1014	1518	43	1	0	44	1	0.022727272727272728
1015	1497	24	0	0	24	0	0
1016	1519	30	2	0	32	2	0.0625
1017	1514	35	1	0	36	1	0.027777777777777776
1018	1516	34	2	0	36	2	0.05555555555555555
1019	1524	36	0	0	36	0	0
102	1505	31	0	0	31	0	0
1020	1523	38	0	0	38	0	0
1021	1478	32	0	0	32	0	0
1022	1518	33	2	0	35	2	0.05714285714285714
1023	1534	27	0	0	27	0	0
1024	1504	28	0	0	28	0	0
1025	1469	28	0	0	28	0	0
1026	1519	31	1	0	32	1	0.03125
1027	1504	31	1	0	32	1	0.03125
1028	1504	29	1	0	30	1	0.03333333333333333
1029	1495	28	2	0	30	2	0.06666666666666667
103	1520	33	1	0	34	1	0.029411764705882353
1030	1483	40	0	0	40	0	0
1031	1515	34	0	0	34	0	0
1032	1505	27	0	0	27	0	0
1033	1480	27	0	0	27	0	0
1034	1504	33	3	0	36	3	0.08333333333333333
1035	1498	33	3	0	36	3	0.08333333333333333
1036	1490	37	1	0	38	1	0.02631578947368421
1037	1543	29	0	0	29	0	0
1038	1460	37	0	0	37	0	0
1039	1480	37	0	0	37	0	0
104	1509	30	1	0	31	1	0.03225806451612903
1040	1502	32	1	0	33	1	0.030303030303030304
1041	1509	30	1	0	31	1	0.03225806451612903
1042	1502	33	0	1	34	1	0.029411764705882353
1043	1514	23	1	0	24	1	0.041666666666666664
1044	1480	31	3	0	34	3	0.08823529411764706
1045	1521	40	0	0	40	0	0
1046	1478	24	0	0	24	0	0
1047	1527	23	1	0	24	1	0.041666666666666664
1048	1526	17	1	0	18	1	0.05555555555555555
1049	1502	25	0	0	25	0	0
105	1520	26	0	0	26	0	0
1050	1522	36	0	0	36	0	0
1051	1530	23	1	0	24	1	0.041666666666666664
1052	1498	31	2	0	33	2	0.06060606060606061
1053	1474	33	1	0	34	1	0.029411764705882353
1054	1518	39	2	0	41	2	0.04878048780487805
1055	1537	32	1	0	33	1	0.030303030303030304
1056	1525	26	2	0	28	2	0.07142857142857142
1057	1511	32	0	0	32	0	0
1058	1520	30	2	0	32	2	0.0625
1059	1538	37	2	0	39	2	0.05128205128205128
106	1507	24	1	0	25	1	0.04
1060	1496	22	3	0	25	3	0.12
1061	1509	32	0	0	32	0	0
1062	1494	33	3	0	36	3	0.08333333333333333
1063	1489	32	1	0	33	1	0.030303030303030304
1064	1498	33	2	0	35	2	0.05714285714285714
1065	1502	30	0	0	30	0	0
1066	1523	25	0	0	25	0	0
1067	1527	28	1	0	29	1	0.034482758620689655
1068	1478	32	0	0	32	0	0
1069	1530	22	0	0	22	0	0
107	1482	24	2	0	26	2	0.07692307692307693
1070	1494	34	2	0	36	2	0.05555555555555555
1071	1519	31	0	0	31	0	0
1072	1517	19	0	0	19	0	0
1073	1497	20	2	0	22	2	0.09090909090909091
1074	1497	32	1	0	33	1	0.030303030303030304
1075	1495	28	1	0	29	1	0.034482758620689655
1076	1462	47	0	0	47	0	0
1077	1509	37	1	0	38	1	0.02631578947368421
1078	1523	35	0	0	35	0	0
1079	1514	37	2	0	39	2	0.05128205128205128
108	1512	34	1	0	35	1	0.02857142857142857
1080	1506	32	2	0	34	2	0.058823529411764705
1081	1520	35	1	0	36	1	0.027777777777777776
1082	1495	34	2	0	36	2	0.05555555555555555
1083	1532	30	1	0	31	1	0.03225806451612903
1084	1503	32	0	0	32	0	0
1085	1501	34	1	0	35	1	0.02857142857142857
1086	1517	31	2	0	33	2	0.06060606060606061
1087	1536	39	1	0	40	1	0.025
1088	1507	38	0	0	38	0	0
1089	1509	33	2	0	35	2	0.05714285714285714
109	1502	29	2	0	31	2	0.06451612903225806
1090	1536	36	0	0	36	0	0
1091	1517	28	0	0	28	0	0
1092	1517	27	1	0	28	1	0.03571428571428571
1093	1566	33	0	0	33	0	0
1094	1528	28	0	0	28	0	0
1095	1472	39	0	0	39	0	0
1096	1505	29	0	0	29	0	0
1097	1493	34	0	0	34	0	0
1098	1472	31	1	0	32	1	0.03125
1099	1497	26	2	0	28	2	0.07142857142857142
11	1493	35	0	0	35	0	0
110	1513	34	0	0	34	0	0
1100	1494	28	1	0	29	1	0.034482758620689655
1101	1516	36	1	0	37	1	0.02702702702702703
1102	1492	34	3	0	37	3	0.08108108108108109
1103	1502	27	3	0	30	3	0.1
1104	1540	17	3	0	20	3	0.15
1105	1498	28	0	0	28	0	0
1106	1476	27	2	0	29	2	0.06896551724137931
1107	1542	29	0	0	29	0	0
1108	1476	27	1	0	28	1	0.03571428571428571
1109	1493	29	1	0	30	1	0.03333333333333333
111	1520	39	1	0	40	1	0.025
1110	1497	33	0	0	33	0	0
1111	1511	28	0	0	28	0	0
1112	1513	28	1	0	29	1	0.034482758620689655
1113	1512	28	1	0	29	1	0.034482758620689655
1114	1518	29	2	0	31	2	0.06451612903225806
1115	1521	28	0	0	28	0	0
1116	1528	34	2	0	36	2	0.05555555555555555
1117	1528	28	1	0	29	1	0.034482758620689655
1118	1519	24	0	0	24	0	0
1119	1519	38	0	0	38	0	0
112	1535	22	1	0	23	1	0.043478260869565216
1120	1534	37	0	0	37	0	0
1121	1500	21	0	0	21	0	0
1122	1507	34	0	0	34	0	0
1123	1525	27	0	0	27	0	0
1124	1515	33	0	0	33	0	0
1125	1538	41	0	1	42	1	0.023809523809523808
1126	1502	22	2	0	24	2	0.08333333333333333
1127	1526	43	1	0	44	1	0.022727272727272728
1128	1486	43	0	0	43	0	0
1129	1501	34	1	0	35	1	0.02857142857142857
113	1489	41	1	0	42	1	0.023809523809523808
1130	1484	29	0	0	29	0	0
1131	1522	26	0	0	26	0	0
1132	1527	32	1	0	33	1	0.030303030303030304
1133	1479	31	0	0	31	0	0
1134	1495	33	0	0	33	0	0
1135	1526	25	1	0	26	1	0.038461538461538464
1136	1513	28	1	0	29	1	0.034482758620689655
1137	1508	36	1	0	37	1	0.02702702702702703
1138	1494	24	1	0	25	1	0.04
1139	1527	31	1	0	32	1	0.03125
114	1510	28	1	0	29	1	0.034482758620689655
1140	1531	34	1	0	35	1	0.02857142857142857
1141	1476	25	2	0	27	2	0.07407407407407407
1142	1510	29	0	0	29	0	0
1143	1537	31	0	0	31	0	0
1144	1490	39	0	0	39	0	0
1145	1520	39	2	0	41	2	0.04878048780487805
1146	1507	33	1	0	34	1	0.029411764705882353
1147	1520	33	3	0	36	3	0.08333333333333333
1148	1516	29	1	0	30	1	0.03333333333333333
1149	1528	33	0	0	33	0	0
115	1525	40	2	0	42	2	0.047619047619047616
1150	1498	25	0	0	25	0	0
1151	1531	27	0	0	27	0	0
1152	1500	27	2	0	29	2	0.06896551724137931
1153	1511	24	1	0	25	1	0.04
1154	1536	30	0	0	30	0	0
1155	1518	44	1	0	45	1	0.022222222222222223
1156	1531	28	0	0	28	0	0
1157	1506	31	1	0	32	1	0.03125
1158	1532	31	1	0	32	1	0.03125
1159	1515	28	1	0	29	1	0.034482758620689655
116	1515	26	2	0	28	2	0.07142857142857142
1160	1507	24	1	0	25	1	0.04
1161	1491	34	0	0	34	0	0
1162	1490	26	0	0	26	0	0
1163	1532	32	1	0	33	1	0.030303030303030304
1164	1510	23	3	0	26	3	0.11538461538461539
1165	1530	18	0	0	18	0	0
1166	1514	30	0	0	30	0	0
1167	1511	38	0	0	38	0	0
1168	1490	36	1	0	37	1	0.02702702702702703
1169	1491	27	0	0	27	0	0
117	1508	36	0	0	36	0	0
1170	1534	28	1	0	29	1	0.034482758620689655
1171	1492	33	1	0	34	1	0.029411764705882353
1172	1539	23	2	0	25	2	0.08
1173	1520	26	0	0	26	0	0
1174	1515	32	0	0	32	0	0
1175	1515	39	1	0	40	1	0.025
1176	1515	33	1	0	34	1	0.029411764705882353
1177	1493	44	1	0	45	1	0.022222222222222223
1178	1533	33	4	0	37	4	0.10810810810810811
1179	1526	30	0	0	30	0	0
118	1496	40	1	0	41	1	0.024390243902439025
1180	1518	27	1	0	28	1	0.03571428571428571
1181	1488	36	1	0	37	1	0.02702702702702703
1182	1530	29	1	0	30	1	0.03333333333333333
1183	1504	25	0	0	25	0	0
1184	1544	28	0	0	28	0	0
1185	1495	29	0	0	29	0	0
1186	1502	36	2	0	38	2	0.05263157894736842
1187	1494	35	5	0	40	5	0.125
1188	1545	22	0	0	22	0	0
1189	1518	27	0	0	27	0	0
119	1539	35	2	0	37	2	0.05405405405405406
1190	1521	19	2	0	21	2	0.09523809523809523
1191	1487	29	0	0	29	0	0
1192	1471	29	1	0	30	1	0.03333333333333333
1193	1512	22	1	0	23	1	0.043478260869565216
1194	1521	37	0	0	37	0	0
1195	1489	31	3	0	34	3	0.08823529411764706
1196	1532	27	1	0	28	1	0.03571428571428571
1197	1496	30	1	0	31	1	0.03225806451612903
1198	1467	43	1	0	44	1	0.022727272727272728
1199	1526	26	1	0	27	1	0.037037037037037035
12	1507	37	1	0	38	1	0.02631578947368421
120	1481	27	0	0	27	0	0
1200	1489	34	0	0	34	0	0
1201	1515	30	1	0	31	1	0.03225806451612903
1202	1480	28	1	0	29	1	0.034482758620689655
1203	1547	28	1	0	29	1	0.034482758620689655
1204	1502	37	1	0	38	1	0.02631578947368421
1205	1513	29	4	0	33	4	0.12121212121212122
1206	1513	25	2	0	27	2	0.07407407407407407
1207	1524	30	1	0	31	1	0.03225806451612903
1208	1501	25	0	0	25	0	0
1209	1522	28	0	0	28	0	0
121	1519	33	2	0	35	2	0.05714285714285714
1210	1526	33	0	0	33	0	0
1211	1544	33	1	0	34	1	0.029411764705882353
1212	1504	30	0	0	30	0	0
1213	1556	30	0	0	30	0	0
1214	1522	32	2	0	34	2	0.058823529411764705
1215	1538	25	1	0	26	1	0.038461538461538464
1216	1496	38	1	0	39	1	0.02564102564102564
1217	1539	35	0	0	35	0	0
1218	1517	29	0	0	29	0	0
1219	1486	34	1	0	35	1	0.02857142857142857
122	1495	36	2	0	38	2	0.05263157894736842
1220	1498	22	0	0	22	0	0
1221	1522	31	0	0	31	0	0
1222	1528	28	1	0	29	1	0.034482758620689655
1223	1509	31	2	0	33	2	0.06060606060606061
1224	1505	26	0	0	26	0	0
1225	1529	33	1	0	34	1	0.029411764705882353
1226	1491	36	2	0	38	2	0.05263157894736842
1227	1533	35	1	0	36	1	0.027777777777777776
1228	1501	30	1	0	31	1	0.03225806451612903
1229	1515	31	1	0	32	1	0.03125
123	1504	34	0	0	34	0	0
1230	1518	40	1	0	41	1	0.024390243902439025
1231	1527	30	1	0	31	1	0.03225806451612903
1232	1548	28	1	0	29	1	0.034482758620689655
1233	1515	28	1	0	29	1	0.034482758620689655
1234	1525	38	2	0	40	2	0.05
1235	1469	36	3	0	39	3	0.07692307692307693
1236	1517	33	1	0	34	1	0.029411764705882353
1237	1516	32	0	0	32	0	0
1238	1515	28	0	0	28	0	0
1239	1507	22	3	0	25	3	0.12
124	1496	33	0	0	33	0	0
1240	1545	29	0	0	29	0	0
1241	1493	25	0	0	25	0	0
1242	1517	37	0	0	37	0	0
1243	1503	23	1	0	24	1	0.041666666666666664
1244	1510	30	1	0	31	1	0.03225806451612903
1245	1473	24	1	0	25	1	0.04
1246	1520	23	1	0	24	1	0.041666666666666664
1247	1492	30	1	0	31	1	0.03225806451612903
1248	1532	17	3	0	20	3	0.15
1249	1499	25	2	0	27	2	0.07407407407407407
125	1534	24	2	0	26	2	0.07692307692307693
1250	1509	29	1	0	30	1	0.03333333333333333
1251	1525	33	2	0	35	2	0.05714285714285714
1252	1513	39	0	0	39	0	0
1253	1494	37	0	0	37	0	0
1254	1505	28	3	0	31	3	0.0967741935483871
1255	1546	36	0	0	36	0	0
1256	1513	34	0	0	34	0	0
1257	1536	39	3	0	42	3	0.07142857142857142
1258	1519	25	0	0	25	0	0
1259	1498	25	0	0	25	0	0
126	1486	38	0	0	38	0	0
1260	1510	23	2	0	25	2	0.08
1261	1512	32	2	0	34	2	0.058823529411764705
1262	1510	34	1	0	35	1	0.02857142857142857
1263	1465	38	1	0	39	1	0.02564102564102564
1264	1504	28	2	0	30	2	0.06666666666666667
1265	1503	31	1	0	32	1	0.03125
1266	1529	25	2	0	27	2	0.07407407407407407
1267	1538	23	0	0	23	0	0
1268	1538	26	1	0	27	1	0.037037037037037035
1269	1534	35	0	0	35	0	0
127	1504	30	1	0	31	1	0.03225806451612903
1270	1500	22	0	0	22	0	0
1271	1530	25	0	0	25	0	0
1272	1516	32	2	0	34	2	0.058823529411764705
1273	1515	29	0	0	29	0	0
1274	1513	30	1	0	31	1	0.03225806451612903
1275	1495	25	1	0	26	1	0.038461538461538464
1276	1517	32	1	0	33	1	0.030303030303030304
1277	1504	37	0	0	37	0	0
1278	1526	30	2	0	32	2	0.0625
1279	1513	29	0	0	29	0	0
128	1494	28	0	0	28	0	0
1280	1500	29	0	0	29	0	0
1281	1506	32	0	0	32	0	0
1282	1504	33	0	0	33	0	0
1283	1531	30	0	0	30	0	0
1284	1515	26	1	0	27	1	0.037037037037037035
1285	1541	20	3	0	23	3	0.13043478260869565
1286	1488	27	1	0	28	1	0.03571428571428571
1287	1525	44	0	0	44	0	0
1288	1505	27	0	0	27	0	0
1289	1510	25	1	0	26	1	0.038461538461538464
129	1457	31	0	0	31	0	0
1290	1492	32	3	0	35	3	0.08571428571428572
1291	1499	31	0	0	31	0	0
1292	1512	25	0	0	25	0	0
1293	1530	22	0	0	22	0	0
1294	1490	35	0	0	35	0	0
1295	1515	37	1	0	38	1	0.02631578947368421
1296	1515	27	0	0	27	0	0
1297	1530	37	1	0	38	1	0.02631578947368421
1298	1525	36	2	0	38	2	0.05263157894736842
1299	1521	22	0	0	22	0	0
13	1470	30	0	0	30	0	0
130	1536	35	1	0	36	1	0.027777777777777776
1300	1527	29	1	0	30	1	0.03333333333333333
1301	1511	26	1	0	27	1	0.037037037037037035
1302	1506	27	1	0	28	1	0.03571428571428571
1303	1471	23	0	0	23	0	0
1304	1523	37	2	0	39	2	0.05128205128205128
1305	1531	34	0	0	34	0	0
1306	1521	22	1	0	23	1	0.043478260869565216
1307	1500	28	1	0	29	1	0.034482758620689655
1308	1482	31	1	0	32	1	0.03125
1309	1500	28	0	0	28	0	0
131	1500	28	0	0	28	0	0
1310	1498	28	1	0	29	1	0.034482758620689655
1311	1503	37	0	0	37	0	0
1312	1509	24	0	0	24	0	0
1313	1528	31	2	0	33	2	0.06060606060606061
1314	1498	34	0	0	34	0	0
1315	1508	33	0	0	33	0	0
1316	1540	30	0	0	30	0	0
1317	1516	34	0	0	34	0	0
1318	1513	32	0	0	32	0	0
1319	1521	47	1	0	48	1	0.020833333333333332
132	1521	28	1	0	29	1	0.034482758620689655
1320	1511	30	1	0	31	1	0.03225806451612903
1321	1519	26	1	0	27	1	0.037037037037037035
1322	1515	28	1	0	29	1	0.034482758620689655
1323	1511	33	3	0	36	3	0.08333333333333333
1324	1487	33	2	0	35	2	0.05714285714285714
1325	1540	41	0	0	41	0	0
1326	1528	38	1	0	39	1	0.02564102564102564
1327	1511	32	2	0	34	2	0.058823529411764705
1328	1496	27	2	0	29	2	0.06896551724137931
1329	1523	30	0	0	30	0	0
133	1526	24	0	0	24	0	0
1330	1507	28	1	0	29	1	0.034482758620689655
1331	1527	30	1	0	31	1	0.03225806451612903
1332	1512	32	1	0	33	1	0.030303030303030304
1333	1528	32	1	0	33	1	0.030303030303030304
1334	1519	34	0	0	34	0	0
1335	1535	29	0	0	29	0	0
1336	1546	22	0	0	22	0	0
1337	1524	20	1	0	21	1	0.047619047619047616
1338	1532	31	1	0	32	1	0.03125
1339	1547	30	1	0	31	1	0.03225806451612903
134	1518	29	0	0	29	0	0
1340	1491	30	1	0	31	1	0.03225806451612903
1341	1505	25	1	0	26	1	0.038461538461538464
1342	1507	33	0	0	33	0	0
1343	1521	33	0	0	33	0	0
1344	1513	29	0	0	29	0	0
1345	1526	34	5	0	39	5	0.1282051282051282
1346	1494	33	1	1	35	2	0.05714285714285714
1347	1529	30	0	0	30	0	0
1348	1491	38	0	0	38	0	0
1349	1492	31	1	0	32	1	0.03125
135	1525	39	0	0	39	0	0
1350	1519	31	2	0	33	2	0.06060606060606061
1351	1483	46	1	0	47	1	0.02127659574468085
1352	1516	22	0	0	22	0	0
1353	1487	34	1	0	35	1	0.02857142857142857
1354	1503	45	1	0	46	1	0.021739130434782608
1355	1501	34	3	0	37	3	0.08108108108108109
1356	1522	36	2	0	38	2	0.05263157894736842
1357	1545	22	0	0	22	0	0
1358	1519	34	0	0	34	0	0
1359	1510	36	1	0	37	1	0.02702702702702703
136	1516	28	2	0	30	2	0.06666666666666667
1360	1486	29	0	0	29	0	0
1361	1520	28	0	0	28	0	0
1362	1517	32	0	0	32	0	0
1363	1509	30	2	0	32	2	0.0625
1364	1519	26	1	0	27	1	0.037037037037037035
1365	1550	21	1	0	22	1	0.045454545454545456
1366	1516	28	2	0	30	2	0.06666666666666667
1367	1534	25	2	0	27	2	0.07407407407407407
1368	1513	42	2	0	44	2	0.045454545454545456
1369	1552	27	2	0	29	2	0.06896551724137931
137	1489	28	1	0	29	1	0.034482758620689655
1370	1500	32	2	0	34	2	0.058823529411764705
1371	1498	29	1	0	30	1	0.03333333333333333
1372	1527	20	0	0	20	0	0
1373	1492	26	1	0	27	1	0.037037037037037035
1374	1516	26	2	0	28	2	0.07142857142857142
1375	1523	31	0	0	31	0	0
1376	1544	24	0	0	24	0	0
1377	1559	34	0	0	34	0	0
1378	1487	21	0	0	21	0	0
1379	1530	28	1	0	29	1	0.034482758620689655
138	1527	32	2	0	34	2	0.058823529411764705
1380	1519	19	0	0	19	0	0
1381	1513	29	2	0	31	2	0.06451612903225806
1382	1473	24	0	0	24	0	0
1383	1538	35	0	0	35	0	0
1384	1548	27	1	0	28	1	0.03571428571428571
1385	1521	27	0	0	27	0	0
1386	1504	27	1	0	28	1	0.03571428571428571
1387	1499	29	1	0	30	1	0.03333333333333333
1388	1525	30	0	0	30	0	0
1389	1489	27	1	0	28	1	0.03571428571428571
139	1495	31	2	0	33	2	0.06060606060606061
1390	1519	26	0	0	26	0	0
1391	1522	30	0	0	30	0	0
1392	1532	28	0	0	28	0	0
1393	1514	34	0	0	34	0	0
1394	1524	33	0	0	33	0	0
1395	1509	22	0	0	22	0	0
1396	1522	35	3	0	38	3	0.07894736842105263
1397	1509	30	2	0	32	2	0.0625
1398	1512	40	1	0	41	1	0.024390243902439025
1399	1497	24	0	0	24	0	0
14	1518	40	1	0	41	1	0.024390243902439025
140	1540	28	1	0	29	1	0.034482758620689655
1400	1514	38	1	0	39	1	0.02564102564102564
1401	1487	33	0	0	33	0	0
1402	1503	34	0	0	34	0	0
1403	1493	33	0	0	33	0	0
1404	1508	32	3	0	35	3	0.08571428571428572
1405	1513	33	0	0	33	0	0
1406	1532	37	1	0	38	1	0.02631578947368421
1407	1494	36	0	0	36	0	0
1408	1518	34	0	0	34	0	0
1409	1500	31	3	0	34	3	0.08823529411764706
141	1482	28	0	0	28	0	0
1410	1513	29	2	1	32	3	0.09375
1411	1529	33	2	0	35	2	0.05714285714285714
1412	1528	24	0	0	24	0	0
1413	1528	31	1	0	32	1	0.03125
1414	1503	29	2	0	31	2	0.06451612903225806
1415	1497	32	0	0	32	0	0
1416	1554	27	3	0	30	3	0.1
1417	1525	30	0	0	30	0	0
1418	1522	29	1	0	30	1	0.03333333333333333
1419	1495	21	0	0	21	0	0
142	1519	27	1	0	28	1	0.03571428571428571
1420	1512	17	0	0	17	0	0
1421	1500	28	0	0	28	0	0
1422	1494	35	1	1	37	2	0.05405405405405406
1423	1515	30	0	0	30	0	0
1424	1507	17	1	0	18	1	0.05555555555555555
1425	1513	21	1	0	22	1	0.045454545454545456
1426	1486	39	0	0	39	0	0
1427	1506	26	3	0	29	3	0.10344827586206896
1428	1539	23	2	0	25	2	0.08
1429	1488	24	1	0	25	1	0.04
143	1495	36	2	0	38	2	0.05263157894736842
1430	1512	26	0	0	26	0	0
1431	1512	36	0	0	36	0	0
1432	1509	24	0	0	24	0	0
1433	1521	22	0	0	22	0	0
1434	1486	40	1	0	41	1	0.024390243902439025
1435	1497	28	0	0	28	0	0
1436	1531	23	0	0	23	0	0
1437	1507	25	0	0	25	0	0
1438	1489	46	3	0	49	3	0.061224489795918366
1439	1519	27	2	0	29	2	0.06896551724137931
144	1524	30	2	0	32	2	0.0625
1440	1500	25	1	0	26	1	0.038461538461538464
1441	1507	32	0	0	32	0	0
1442	1515	29	2	0	31	2	0.06451612903225806
1443	1535	31	2	0	33	2	0.06060606060606061
1444	1498	26	0	1	27	1	0.037037037037037035
1445	1499	33	0	0	33	0	0
1446	1520	32	2	0	34	2	0.058823529411764705
1447	1515	25	1	0	26	1	0.038461538461538464
1448	1486	30	2	0	32	2	0.0625
1449	1504	41	0	0	41	0	0
145	1534	25	0	0	25	0	0
1450	1503	13	1	0	14	1	0.07142857142857142
1451	1492	41	1	0	42	1	0.023809523809523808
1452	1529	33	2	0	35	2	0.05714285714285714
1453	1537	30	2	0	32	2	0.0625
1454	1491	35	1	0	36	1	0.027777777777777776
1455	1520	29	0	0	29	0	0
1456	1515	33	1	0	34	1	0.029411764705882353
1457	1538	31	1	0	32	1	0.03125
1458	1480	43	1	0	44	1	0.022727272727272728
1459	1517	28	1	0	29	1	0.034482758620689655
146	1508	26	0	0	26	0	0
1460	1511	36	1	0	37	1	0.02702702702702703
1461	1512	22	1	0	23	1	0.043478260869565216
1462	1491	22	0	0	22	0	0
1463	1528	28	0	0	28	0	0
1464	1521	32	0	0	32	0	0
1465	1502	28	1	0	29	1	0.034482758620689655
1466	1493	32	0	0	32	0	0
1467	1542	30	0	0	30	0	0
1468	1530	32	1	0	33	1	0.030303030303030304
1469	1530	28	0	0	28	0	0
147	1510	21	0	0	21	0	0
1470	1514	41	0	0	41	0	0
1471	1476	29	1	0	30	1	0.03333333333333333
1472	1493	28	0	0	28	0	0
1473	1489	32	1	0	33	1	0.030303030303030304
1474	1534	31	2	0	33	2	0.06060606060606061
1475	1528	33	0	0	33	0	0
1476	1496	26	1	0	27	1	0.037037037037037035
1477	1520	33	1	0	34	1	0.029411764705882353
1478	1510	33	0	0	33	0	0
1479	1514	37	0	0	37	0	0
148	1473	28	1	0	29	1	0.034482758620689655
1480	1470	28	1	0	29	1	0.034482758620689655
1481	1506	30	1	0	31	1	0.03225806451612903
1482	1495	35	2	0	37	2	0.05405405405405406
1483	1532	36	1	0	37	1	0.02702702702702703
1484	1517	19	1	0	20	1	0.05
1485	1494	21	2	0	23	2	0.08695652173913043
1486	1529	29	0	0	29	0	0
1487	1513	32	0	0	32	0	0
1488	1520	26	0	0	26	0	0
1489	1518	32	2	0	34	2	0.058823529411764705
149	1519	33	0	0	33	0	0
1490	1521	26	1	0	27	1	0.037037037037037035
1491	1538	33	1	0	34	1	0.029411764705882353
1492	1526	23	2	0	25	2	0.08
1493	1525	27	0	0	27	0	0
1494	1522	37	1	0	38	1	0.02631578947368421
1495	1499	31	0	0	31	0	0
1496	1500	35	2	0	37	2	0.05405405405405406
1497	1497	38	0	0	38	0	0
1498	1546	25	1	0	26	1	0.038461538461538464
1499	1515	41	1	0	42	1	0.023809523809523808
15	1578	30	1	0	31	1	0.03225806451612903
150	1540	28	1	1	30	2	0.06666666666666667
1500	1497	25	1	0	26	1	0.038461538461538464
1501	1525	38	0	0	38	0	0
1502	1535	33	0	0	33	0	0
1503	1506	32	2	0	34	2	0.058823529411764705
1504	1494	32	2	0	34	2	0.058823529411764705
1505	1535	33	3	0	36	3	0.08333333333333333
1506	1518	31	1	0	32	1	0.03125
1507	1506	25	1	0	26	1	0.038461538461538464
1508	1506	34	3	0	37	3	0.08108108108108109
1509	1521	31	0	0	31	0	0
151	1526	35	1	0	36	1	0.027777777777777776
1510	1506	46	0	0	46	0	0
1511	1508	34	1	0	35	1	0.02857142857142857
1512	1526	37	1	0	38	1	0.02631578947368421
1513	1483	21	0	0	21	0	0
1514	1513	26	1	0	27	1	0.037037037037037035
1515	1515	20	2	0	22	2	0.09090909090909091
1516	1520	26	1	0	27	1	0.037037037037037035
1517	1522	36	0	0	36	0	0
1518	1531	28	0	0	28	0	0
1519	1462	39	1	0	40	1	0.025
152	1510	31	2	0	33	2	0.06060606060606061
1520	1522	35	1	0	36	1	0.027777777777777776
1521	1533	30	0	0	30	0	0
1522	1500	29	1	0	30	1	0.03333333333333333
1523	1501	42	0	0	42	0	0
1524	1535	25	1	0	26	1	0.038461538461538464
1525	1505	30	1	0	31	1	0.03225806451612903
1526	1523	26	0	0	26	0	0
1527	1490	27	1	0	28	1	0.03571428571428571
1528	1516	33	0	0	33	0	0
1529	1535	29	3	0	32	3	0.09375
153	1508	27	0	1	28	1	0.03571428571428571
1530	1485	20	1	0	21	1	0.047619047619047616
1531	1526	34	3	0	37	3	0.08108108108108109
1532	1537	33	0	0	33	0	0
1533	1514	30	1	0	31	1	0.03225806451612903
1534	1511	41	1	0	42	1	0.023809523809523808
1535	1501	29	0	0	29	0	0
1536	1501	30	2	0	32	2	0.0625
1537	1517	27	2	0	29	2	0.06896551724137931
1538	1506	32	1	0	33	1	0.030303030303030304
1539	1525	30	1	0	31	1	0.03225806451612903
154	1530	30	0	0	30	0	0
1540	1538	25	0	0	25	0	0
1541	1511	42	1	0	43	1	0.023255813953488372
1542	1523	39	0	0	39	0	0
1543	1500	29	2	0	31	2	0.06451612903225806
1544	1523	25	0	0	25	0	0
1545	1517	23	0	0	23	0	0
1546	1514	28	0	0	28	0	0
1547	1512	30	0	0	30	0	0
1548	1526	37	0	0	37	0	0
1549	1515	19	2	0	21	2	0.09523809523809523
155	1524	28	1	0	29	1	0.034482758620689655
1550	1484	24	1	0	25	1	0.04
1551	1527	31	1	0	32	1	0.03125
1552	1533	28	0	0	28	0	0
1553	1547	28	0	0	28	0	0
1554	1530	28	0	0	28	0	0
1555	1524	28	0	0	28	0	0
1556	1507	21	1	0	22	1	0.045454545454545456
1557	1501	34	1	0	35	1	0.02857142857142857
1558	1501	35	1	0	36	1	0.027777777777777776
1559	1520	31	1	0	32	1	0.03125
156	1509	41	0	0	41	0	0
1560	1509	28	2	0	30	2	0.06666666666666667
1561	1503	31	1	0	32	1	0.03125
1562	1522	18	0	0	18	0	0
1563	1526	31	0	0	31	0	0
1564	1519	38	0	0	38	0	0
1565	1496	32	1	0	33	1	0.030303030303030304
1566	1528	30	1	0	31	1	0.03225806451612903
1567	1505	29	0	0	29	0	0
1568	1536	21	1	0	22	1	0.045454545454545456
1569	1523	29	0	0	29	0	0
157	1532	25	1	0	26	1	0.038461538461538464
1570	1509	29	0	0	29	0	0
1571	1511	31	0	0	31	0	0
1572	1533	24	0	0	24	0	0
1573	1521	36	0	0	36	0	0
1574	1480	40	2	0	42	2	0.047619047619047616
1575	1506	36	0	0	36	0	0
1576	1514	31	0	0	31	0	0
1577	1519	36	1	0	37	1	0.02702702702702703
1578	1488	27	1	0	28	1	0.03571428571428571
1579	1496	30	0	0	30	0	0
158	1511	31	0	0	31	0	0
1580	1489	29	1	0	30	1	0.03333333333333333
1581	1514	30	1	0	31	1	0.03225806451612903
1582	1555	26	0	0	26	0	0
1583	1525	40	1	0	41	1	0.024390243902439025
1584	1510	30	2	0	32	2	0.0625
1585	1481	39	2	0	41	2	0.04878048780487805
1586	1488	33	0	0	33	0	0
1587	1518	27	2	0	29	2	0.06896551724137931
1588	1505	41	1	0	42	1	0.023809523809523808
1589	1485	23	2	0	25	2	0.08
159	1506	35	1	0	36	1	0.027777777777777776
1590	1499	34	1	0	35	1	0.02857142857142857
1591	1486	28	0	0	28	0	0
1592	1506	36	0	1	37	1	0.02702702702702703
1593	1515	34	0	0	34	0	0
1594	1486	29	0	0	29	0	0
1595	1493	39	2	0	41	2	0.04878048780487805
1596	1479	29	3	0	32	3	0.09375
1597	1513	25	1	0	26	1	0.038461538461538464
1598	1508	35	1	0	36	1	0.027777777777777776
1599	1508	39	0	0	39	0	0
16	1537	26	1	0	27	1	0.037037037037037035
160	1538	27	0	0	27	0	0
1600	1526	32	1	0	33	1	0.030303030303030304
1601	1506	18	1	0	19	1	0.05263157894736842
1602	1522	36	0	0	36	0	0
1603	1490	33	0	0	33	0	0
1604	1526	26	2	0	28	2	0.07142857142857142
1605	1519	31	1	0	32	1	0.03125
1606	1491	23	2	0	25	2	0.08
1607	1514	32	3	0	35	3	0.08571428571428572
1608	1518	28	0	0	28	0	0
1609	1528	25	1	0	26	1	0.038461538461538464
161	1511	27	0	0	27	0	0
1610	1530	33	0	0	33	0	0
1611	1490	21	0	0	21	0	0
1612	1532	34	0	0	34	0	0
1613	1509	36	0	0	36	0	0
1614	1517	33	0	0	33	0	0
1615	1502	29	2	0	31	2	0.06451612903225806
1616	1498	28	2	0	30	2	0.06666666666666667
1617	1521	36	0	0	36	0	0
1618	1498	23	0	0	23	0	0
1619	1498	31	1	0	32	1	0.03125
162	1524	28	0	0	28	0	0
1620	1539	31	3	0	34	3	0.08823529411764706
1621	1496	30	4	0	34	4	0.11764705882352941
1622	1492	32	1	0	33	1	0.030303030303030304
1623	1490	30	0	0	30	0	0
1624	1508	30	2	0	32	2	0.0625
1625	1518	39	0	0	39	0	0
1626	1494	30	1	0	31	1	0.03225806451612903
1627	1508	30	0	0	30	0	0
1628	1489	40	1	0	41	1	0.024390243902439025
1629	1546	22	0	0	22	0	0
163	1523	30	5	0	35	5	0.14285714285714285
1630	1488	35	1	0	36	1	0.027777777777777776
1631	1496	34	0	0	34	0	0
1632	1509	31	0	0	31	0	0
1633	1496	26	0	0	26	0	0
1634	1516	30	0	0	30	0	0
1635	1484	27	3	0	30	3	0.1
1636	1519	28	0	0	28	0	0
1637	1476	32	0	0	32	0	0
1638	1533	29	1	0	30	1	0.03333333333333333
1639	1519	24	2	0	26	2	0.07692307692307693
164	1525	27	0	0	27	0	0
1640	1497	25	0	0	25	0	0
1641	1547	35	0	0	35	0	0
1642	1511	35	2	0	37	2	0.05405405405405406
1643	1546	27	0	0	27	0	0
1644	1472	28	2	0	30	2	0.06666666666666667
1645	1514	31	1	0	32	1	0.03125
1646	1505	31	0	0	31	0	0
1647	1526	28	1	0	29	1	0.034482758620689655
1648	1504	40	1	0	41	1	0.024390243902439025
1649	1522	30	0	0	30	0	0
165	1531	27	1	0	28	1	0.03571428571428571
1650	1509	37	0	0	37	0	0
1651	1478	30	1	0	31	1	0.03225806451612903
1652	1504	36	1	0	37	1	0.02702702702702703
1653	1555	34	0	0	34	0	0
1654	1512	33	0	0	33	0	0
1655	1485	29	2	0	31	2	0.06451612903225806
1656	1537	32	1	0	33	1	0.030303030303030304
1657	1466	30	1	0	31	1	0.03225806451612903
1658	1509	50	0	0	50	0	0
1659	1493	23	0	0	23	0	0
166	1502	27	1	0	28	1	0.03571428571428571
1660	1471	24	0	0	24	0	0
1661	1508	41	2	0	43	2	0.046511627906976744
1662	1502	33	0	0	33	0	0
1663	1520	33	1	0	34	1	0.029411764705882353
1664	1490	25	1	0	26	1	0.038461538461538464
1665	1489	31	1	0	32	1	0.03125
1666	1528	25	0	0	25	0	0
1667	1520	31	1	0	32	1	0.03125
1668	1484	29	2	0	31	2	0.06451612903225806
1669	1432	23	1	0	24	1	0.041666666666666664
167	1485	28	4	0	32	4	0.125
1670	1516	35	2	0	37	2	0.05405405405405406
1671	1530	22	0	0	22	0	0
1672	1511	29	0	0	29	0	0
1673	1499	40	0	0	40	0	0
1674	1517	37	3	0	40	3	0.075
1675	1499	43	0	0	43	0	0
1676	1526	23	0	0	23	0	0
1677	1513	35	1	0	36	1	0.027777777777777776
1678	1493	32	0	0	32	0	0
1679	1496	24	1	0	25	1	0.04
168	1517	40	1	0	41	1	0.024390243902439025
1680	1467	26	0	0	26	0	0
1681	1518	40	1	0	41	1	0.024390243902439025
1682	1488	34	2	0	36	2	0.05555555555555555
1683	1539	36	1	0	37	1	0.02702702702702703
1684	1509	39	0	0	39	0	0
1685	1535	30	0	0	30	0	0
1686	1484	31	0	0	31	0	0
1687	1517	28	0	0	28	0	0
1688	1489	30	0	0	30	0	0
1689	1482	29	1	0	30	1	0.03333333333333333
169	1494	33	0	0	33	0	0
1690	1508	19	0	0	19	0	0
1691	1516	30	0	0	30	0	0
1692	1527	34	1	0	35	1	0.02857142857142857
1693	1512	32	2	0	34	2	0.058823529411764705
1694	1510	36	0	0	36	0	0
1695	1502	30	2	0	32	2	0.0625
1696	1496	21	4	0	25	4	0.16
1697	1506	32	0	0	32	0	0
1698	1503	26	0	0	26	0	0
1699	1514	34	3	0	37	3	0.08108108108108109
17	1514	35	0	0	35	0	0
170	1510	37	2	0	39	2	0.05128205128205128
1700	1527	33	0	0	33	0	0
1701	1516	34	3	0	37	3	0.08108108108108109
1702	1516	19	0	0	19	0	0
1703	1504	38	2	0	40	2	0.05
1704	1488	29	0	0	29	0	0
1705	1516	32	3	0	35	3	0.08571428571428572
1706	1491	30	0	0	30	0	0
1707	1508	38	1	0	39	1	0.02564102564102564
1708	1529	34	1	0	35	1	0.02857142857142857
1709	1509	25	1	0	26	1	0.038461538461538464
171	1546	27	0	0	27	0	0
1710	1516	29	0	0	29	0	0
1711	1522	24	1	0	25	1	0.04
1712	1506	30	1	0	31	1	0.03225806451612903
1713	1538	30	1	0	31	1	0.03225806451612903
1714	1480	31	0	0	31	0	0
1715	1486	30	2	0	32	2	0.0625
1716	1509	32	2	0	34	2	0.058823529411764705
1717	1488	31	0	0	31	0	0
1718	1508	30	0	0	30	0	0
1719	1492	39	1	0	40	1	0.025
172	1503	30	3	0	33	3	0.09090909090909091
1720	1525	39	0	0	39	0	0
1721	1521	26	1	0	27	1	0.037037037037037035
1722	1520	23	1	0	24	1	0.041666666666666664
1723	1513	30	1	0	31	1	0.03225806451612903
1724	1532	37	0	0	37	0	0
1725	1500	32	0	0	32	0	0
1726	1476	35	0	0	35	0	0
1727	1484	41	0	0	41	0	0
1728	1523	28	0	0	28	0	0
1729	1493	28	0	0	28	0	0
173	1479	29	1	0	30	1	0.03333333333333333
1730	1508	35	1	0	36	1	0.027777777777777776
1731	1518	27	2	0	29	2	0.06896551724137931
1732	1501	33	1	0	34	1	0.029411764705882353
1733	1533	27	1	0	28	1	0.03571428571428571
1734	1541	30	1	0	31	1	0.03225806451612903
1735	1491	39	3	0	42	3	0.07142857142857142
1736	1489	37	6	0	43	6	0.13953488372093023
1737	1509	38	0	1	39	1	0.02564102564102564
1738	1539	27	3	0	30	3	0.1
1739	1538	33	0	0	33	0	0
174	1484	31	0	0	31	0	0
1740	1539	32	1	0	33	1	0.030303030303030304
1741	1510	27	0	0	27	0	0
1742	1548	27	1	0	28	1	0.03571428571428571
1743	1469	28	1	0	29	1	0.034482758620689655
1744	1496	30	1	0	31	1	0.03225806451612903
1745	1498	30	1	0	31	1	0.03225806451612903
1746	1520	41	1	0	42	1	0.023809523809523808
1747	1528	24	0	0	24	0	0
1748	1536	31	1	0	32	1	0.03125
1749	1522	31	0	0	31	0	0
175	1512	32	1	0	33	1	0.030303030303030304
1750	1517	29	1	0	30	1	0.03333333333333333
1751	1513	27	2	0	29	2	0.06896551724137931
1752	1506	33	0	0	33	0	0
1753	1508	31	1	0	32	1	0.03125
1754	1529	25	1	0	26	1	0.038461538461538464
1755	1510	37	0	0	37	0	0
1756	1523	32	0	0	32	0	0
1757	1478	36	3	0	39	3	0.07692307692307693
1758	1488	33	1	0	34	1	0.029411764705882353
1759	1510	37	0	0	37	0	0
176	1538	30	1	0	31	1	0.03225806451612903
1760	1499	31	1	0	32	1	0.03125
1761	1497	34	0	0	34	0	0
1762	1502	33	0	0	33	0	0
1763	1524	34	0	0	34	0	0
1764	1524	36	0	0	36	0	0
1765	1519	28	0	0	28	0	0
1766	1502	26	0	0	26	0	0
1767	1501	28	1	0	29	1	0.034482758620689655
1768	1513	32	1	0	33	1	0.030303030303030304
1769	1528	36	2	0	38	2	0.05263157894736842
177	1504	38	1	0	39	1	0.02564102564102564
1770	1503	36	0	0	36	0	0
1771	1481	30	2	0	32	2	0.0625
1772	1499	33	2	0	35	2	0.05714285714285714
1773	1513	26	4	0	30	4	0.13333333333333333
1774	1518	23	1	0	24	1	0.041666666666666664
1775	1471	22	1	0	23	1	0.043478260869565216
1776	1513	31	1	0	32	1	0.03125
1777	1538	34	2	0	36	2	0.05555555555555555
1778	1507	22	2	0	24	2	0.08333333333333333
1779	1522	30	2	0	32	2	0.0625
178	1518	35	0	0	35	0	0
1780	1529	37	2	0	39	2	0.05128205128205128
1781	1509	24	1	0	25	1	0.04
1782	1495	34	1	0	35	1	0.02857142857142857
1783	1513	27	2	0	29	2	0.06896551724137931
1784	1508	26	1	0	27	1	0.037037037037037035
1785	1514	24	2	0	26	2	0.07692307692307693
1786	1507	31	2	0	33	2	0.06060606060606061
1787	1475	28	1	0	29	1	0.034482758620689655
1788	1519	24	0	0	24	0	0
1789	1523	37	1	0	38	1	0.02631578947368421
179	1505	41	1	0	42	1	0.023809523809523808
1790	1534	32	0	0	32	0	0
1791	1500	27	0	0	27	0	0
1792	1503	24	0	0	24	0	0
1793	1486	26	1	0	27	1	0.037037037037037035
1794	1510	30	1	0	31	1	0.03225806451612903
1795	1496	32	1	0	33	1	0.030303030303030304
1796	1527	27	0	0	27	0	0
1797	1501	22	2	0	24	2	0.08333333333333333
1798	1469	31	1	0	32	1	0.03125
1799	1481	28	1	0	29	1	0.034482758620689655
18	1537	31	0	0	31	0	0
180	1554	31	0	0	31	0	0
1800	1521	37	1	0	38	1	0.02631578947368421
1801	1508	36	0	0	36	0	0
1802	1539	37	1	0	38	1	0.02631578947368421
1803	1510	27	0	0	27	0	0
1804	1522	23	0	0	23	0	0
1805	1521	22	0	0	22	0	0
1806	1541	30	0	0	30	0	0
1807	1538	30	0	0	30	0	0
1808	1502	30	1	0	31	1	0.03225806451612903
1809	1522	33	1	0	34	1	0.029411764705882353
181	1518	30	1	0	31	1	0.03225806451612903
1810	1504	28	0	0	28	0	0
1811	1503	23	1	0	24	1	0.041666666666666664
1812	1499	38	0	0	38	0	0
1813	1502	28	0	0	28	0	0
1814	1507	27	1	0	28	1	0.03571428571428571
1815	1554	25	0	0	25	0	0
1816	1498	34	1	0	35	1	0.02857142857142857
1817	1502	32	1	0	33	1	0.030303030303030304
1818	1505	29	4	0	33	4	0.12121212121212122
1819	1488	28	0	0	28	0	0
182	1527	42	1	0	43	1	0.023255813953488372
1820	1546	33	1	0	34	1	0.029411764705882353
1821	1510	36	2	0	38	2	0.05263157894736842
1822	1505	27	1	0	28	1	0.03571428571428571
1823	1499	32	0	0	32	0	0
1824	1519	31	0	0	31	0	0
1825	1495	27	0	0	27	0	0
1826	1513	38	0	0	38	0	0
1827	1531	29	1	0	30	1	0.03333333333333333
1828	1473	41	0	0	41	0	0
1829	1501	35	1	0	36	1	0.027777777777777776
183	1523	34	2	0	36	2	0.05555555555555555
1830	1498	27	1	0	28	1	0.03571428571428571
1831	1492	29	0	0	29	0	0
1832	1478	31	0	0	31	0	0
1833	1525	29	2	0	31	2	0.06451612903225806
1834	1521	29	1	0	30	1	0.03333333333333333
1835	1524	31	1	0	32	1	0.03125
1836	1496	27	0	0	27	0	0
1837	1542	26	1	0	27	1	0.037037037037037035
1838	1520	29	1	0	30	1	0.03333333333333333
1839	1503	33	0	0	33	0	0
184	1518	30	1	0	31	1	0.03225806451612903
1840	1542	31	1	0	32	1	0.03125
1841	1489	38	1	0	39	1	0.02564102564102564
1842	1494	19	2	0	21	2	0.09523809523809523
1843	1535	33	2	0	35	2	0.05714285714285714
1844	1515	28	0	0	28	0	0
1845	1521	21	0	0	21	0	0
1846	1495	38	1	0	39	1	0.02564102564102564
1847	1520	29	0	0	29	0	0
1848	1527	28	1	0	29	1	0.034482758620689655
1849	1518	28	1	0	29	1	0.034482758620689655
185	1496	35	0	0	35	0	0
1850	1516	26	3	0	29	3	0.10344827586206896
1851	1517	34	1	0	35	1	0.02857142857142857
1852	1509	29	2	0	31	2	0.06451612903225806
1853	1498	35	1	0	36	1	0.027777777777777776
1854	1500	26	0	0	26	0	0
1855	1517	29	0	0	29	0	0
1856	1527	35	4	0	39	4	0.10256410256410256
1857	1502	29	0	0	29	0	0
1858	1532	27	0	0	27	0	0
1859	1511	23	2	0	25	2	0.08
186	1524	37	1	0	38	1	0.02631578947368421
1860	1498	26	2	0	28	2	0.07142857142857142
1861	1469	40	0	0	40	0	0
1862	1508	40	2	0	42	2	0.047619047619047616
1863	1500	40	1	0	41	1	0.024390243902439025
1864	1514	32	0	0	32	0	0
1865	1533	23	2	0	25	2	0.08
1866	1494	36	1	0	37	1	0.02702702702702703
1867	1473	34	1	0	35	1	0.02857142857142857
1868	1492	31	1	0	32	1	0.03125
1869	1526	45	2	0	47	2	0.0425531914893617
187	1510	26	0	0	26	0	0
1870	1516	28	1	0	29	1	0.034482758620689655
1871	1530	20	1	0	21	1	0.047619047619047616
1872	1540	38	2	0	40	2	0.05
1873	1530	30	0	0	30	0	0
1874	1514	38	1	0	39	1	0.02564102564102564
1875	1507	35	0	0	35	0	0
1876	1519	39	0	0	39	0	0
1877	1500	36	0	0	36	0	0
1878	1513	24	1	0	25	1	0.04
1879	1478	33	0	0	33	0	0
188	1515	25	0	0	25	0	0
1880	1529	28	1	0	29	1	0.034482758620689655
1881	1517	31	2	0	33	2	0.06060606060606061
1882	1495	36	1	0	37	1	0.02702702702702703
1883	1498	35	1	0	36	1	0.027777777777777776
1884	1504	32	1	0	33	1	0.030303030303030304
1885	1528	23	2	0	25	2	0.08
1886	1519	31	0	0	31	0	0
1887	1525	29	2	0	31	2	0.06451612903225806
1888	1506	36	2	0	38	2	0.05263157894736842
1889	1526	27	0	0	27	0	0
189	1501	37	2	0	39	2	0.05128205128205128
1890	1501	26	0	0	26	0	0
1891	1529	21	1	0	22	1	0.045454545454545456
1892	1456	27	1	0	28	1	0.03571428571428571
1893	1535	29	1	0	30	1	0.03333333333333333
1894	1534	33	2	0	35	2	0.05714285714285714
1895	1511	37	0	0	37	0	0
1896	1506	32	0	0	32	0	0
1897	1489	34	1	0	35	1	0.02857142857142857
1898	1499	26	0	0	26	0	0
1899	1512	30	0	0	30	0	0
19	1485	32	0	0	32	0	0
190	1503	28	0	0	28	0	0
1900	1533	25	1	0	26	1	0.038461538461538464
1901	1530	25	0	0	25	0	0
1902	1522	24	1	0	25	1	0.04
1903	1521	39	2	0	41	2	0.04878048780487805
1904	1531	37	0	0	37	0	0
1905	1516	28	0	0	28	0	0
1906	1489	30	2	0	32	2	0.0625
1907	1518	36	3	0	39	3	0.07692307692307693
1908	1472	32	1	0	33	1	0.030303030303030304
1909	1503	34	2	0	36	2	0.05555555555555555
191	1522	30	0	0	30	0	0
1910	1510	31	1	0	32	1	0.03125
1911	1536	28	1	0	29	1	0.034482758620689655
1912	1495	37	0	0	37	0	0
1913	1535	30	2	0	32	2	0.0625
1914	1527	23	0	0	23	0	0
1915	1526	24	0	0	24	0	0
1916	1527	34	0	0	34	0	0
1917	1499	29	0	0	29	0	0
1918	1511	42	1	0	43	1	0.023255813953488372
1919	1489	32	1	0	33	1	0.030303030303030304
192	1481	37	0	0	37	0	0
1920	1512	23	1	0	24	1	0.041666666666666664
1921	1501	27	1	0	28	1	0.03571428571428571
1922	1548	32	1	0	33	1	0.030303030303030304
1923	1543	24	1	0	25	1	0.04
1924	1503	26	0	0	26	0	0
1925	1494	32	1	0	33	1	0.030303030303030304
1926	1505	33	2	0	35	2	0.05714285714285714
1927	1534	31	1	0	32	1	0.03125
1928	1500	46	1	1	48	2	0.041666666666666664
1929	1532	23	3	0	26	3	0.11538461538461539
193	1538	31	2	0	33	2	0.06060606060606061
1930	1524	24	1	0	25	1	0.04
1931	1478	37	0	0	37	0	0
1932	1501	40	1	0	41	1	0.024390243902439025
1933	1511	29	1	0	30	1	0.03333333333333333
1934	1509	31	2	0	33	2	0.06060606060606061
1935	1542	31	1	0	32	1	0.03125
1936	1507	25	0	0	25	0	0
1937	1518	43	1	0	44	1	0.022727272727272728
1938	1520	30	0	0	30	0	0
1939	1532	34	0	0	34	0	0
194	1483	24	0	0	24	0	0
1940	1515	41	0	0	41	0	0
1941	1535	35	0	0	35	0	0
1942	1509	44	0	0	44	0	0
1943	1519	29	0	0	29	0	0
1944	1508	42	0	0	42	0	0
1945	1518	39	1	0	40	1	0.025
1946	1512	36	0	0	36	0	0
1947	1507	40	1	0	41	1	0.024390243902439025
1948	1513	30	0	0	30	0	0
1949	1502	30	0	0	30	0	0
195	1479	22	1	0	23	1	0.043478260869565216
1950	1508	37	1	0	38	1	0.02631578947368421
1951	1504	29	1	0	30	1	0.03333333333333333
1952	1549	31	1	0	32	1	0.03125
1953	1506	23	1	0	24	1	0.041666666666666664
1954	1484	19	1	0	20	1	0.05
1955	1518	23	3	0	26	3	0.11538461538461539
1956	1524	38	0	0	38	0	0
1957	1515	28	0	0	28	0	0
1958	1502	35	1	0	36	1	0.027777777777777776
1959	1560	33	0	0	33	0	0
196	1494	33	0	0	33	0	0
1960	1541	33	1	0	34	1	0.029411764705882353
1961	1511	31	2	0	33	2	0.06060606060606061
1962	1533	24	1	0	25	1	0.04
1963	1486	41	2	0	43	2	0.046511627906976744
1964	1513	22	2	0	24	2	0.08333333333333333
1965	1525	25	1	0	26	1	0.038461538461538464
1966	1532	29	0	0	29	0	0
1967	1507	25	2	0	27	2	0.07407407407407407
1968	1519	35	0	0	35	0	0
1969	1547	31	0	0	31	0	0
197	1528	23	0	0	23	0	0
1970	1504	18	1	0	19	1	0.05263157894736842
1971	1475	23	1	0	24	1	0.041666666666666664
1972	1514	25	1	0	26	1	0.038461538461538464
1973	1477	23	1	0	24	1	0.041666666666666664
1974	1523	26	0	0	26	0	0
1975	1495	23	0	0	23	0	0
1976	1511	32	0	0	32	0	0
1977	1500	23	1	0	24	1	0.041666666666666664
1978	1509	29	1	0	30	1	0.03333333333333333
1979	1497	27	0	0	27	0	0
198	1514	28	1	0	29	1	0.034482758620689655
1980	1509	38	2	0	40	2	0.05
1981	1466	38	2	0	40	2	0.05
1982	1541	20	1	0	21	1	0.047619047619047616
1983	1502	31	3	0	34	3	0.08823529411764706
1984	1527	33	1	0	34	1	0.029411764705882353
1985	1507	28	0	0	28	0	0
1986	1472	42	0	0	42	0	0
1987	1479	35	1	0	36	1	0.027777777777777776
1988	1501	22	2	0	24	2	0.08333333333333333
1989	1510	43	0	0	43	0	0
199	1500	44	0	0	44	0	0
1990	1543	23	1	0	24	1	0.041666666666666664
1991	1496	30	1	0	31	1	0.03225806451612903
1992	1525	30	0	0	30	0	0
1993	1509	22	2	0	24	2	0.08333333333333333
1994	1456	36	1	0	37	1	0.02702702702702703
1995	1534	25	0	0	25	0	0
1996	1489	31	0	0	31	0	0
1997	1504	31	1	0	32	1	0.03125
1998	1505	28	0	0	28	0	0
1999	1514	23	0	0	23	0	0
2	1559	35	0	0	35	0	0
20	1497	27	1	0	28	1	0.03571428571428571
200	1523	30	0	0	30	0	0
2000	1509	29	3	0	32	3	0.09375
2001	1494	29	1	0	30	1	0.03333333333333333
2002	1499	33	1	0	34	1	0.029411764705882353
2003	1520	28	0	0	28	0	0
2004	1497	27	1	0	28	1	0.03571428571428571
2005	1530	28	0	0	28	0	0
2006	1510	27	1	0	28	1	0.03571428571428571
2007	1521	34	0	0	34	0	0
2008	1511	40	0	0	40	0	0
2009	1531	34	0	0	34	0	0
201	1483	28	1	0	29	1	0.034482758620689655
2010	1510	28	0	0	28	0	0
2011	1546	33	0	0	33	0	0
2012	1534	27	1	0	28	1	0.03571428571428571
2013	1505	22	0	0	22	0	0
2014	1539	30	1	0	31	1	0.03225806451612903
2015	1538	33	0	0	33	0	0
2016	1476	43	2	0	45	2	0.044444444444444446
2017	1505	34	2	0	36	2	0.05555555555555555
2018	1492	31	2	0	33	2	0.06060606060606061
2019	1487	26	1	0	27	1	0.037037037037037035
202	1525	31	1	0	32	1	0.03125
2020	1493	30	2	0	32	2	0.0625
2021	1490	40	0	0	40	0	0
2022	1499	27	3	0	30	3	0.1
2023	1499	29	1	0	30	1	0.03333333333333333
2024	1530	31	1	0	32	1	0.03125
2025	1534	32	0	0	32	0	0
2026	1501	23	0	0	23	0	0
2027	1511	37	2	0	39	2	0.05128205128205128
2028	1532	30	1	0	31	1	0.03225806451612903
2029	1483	29	0	0	29	0	0
203	1506	31	1	0	32	1	0.03125
2030	1508	31	0	0	31	0	0
2031	1534	29	0	0	29	0	0
2032	1541	23	0	0	23	0	0
2033	1525	33	1	0	34	1	0.029411764705882353
2034	1504	24	0	0	24	0	0
2035	1525	24	0	0	24	0	0
2036	1528	23	2	0	25	2	0.08
2037	1480	22	2	0	24	2	0.08333333333333333
2038	1481	38	0	0	38	0	0
2039	1500	27	0	0	27	0	0
204	1554	32	0	0	32	0	0
2040	1515	38	1	0	39	1	0.02564102564102564
2041	1509	37	1	0	38	1	0.02631578947368421
2042	1528	23	1	0	24	1	0.041666666666666664
2043	1503	27	2	0	29	2	0.06896551724137931
2044	1519	30	0	0	30	0	0
2045	1541	29	0	0	29	0	0
2046	1551	43	0	0	43	0	0
2047	1489	32	1	0	33	1	0.030303030303030304
2048	1525	31	1	0	32	1	0.03125
2049	1535	25	0	1	26	1	0.038461538461538464
205	1505	32	0	0	32	0	0
2050	1489	26	1	0	27	1	0.037037037037037035
2051	1515	31	0	0	31	0	0
2052	1526	35	1	0	36	1	0.027777777777777776
2053	1506	36	0	0	36	0	0
2054	1516	31	1	0	32	1	0.03125
2055	1485	36	2	0	38	2	0.05263157894736842
2056	1524	26	2	0	28	2	0.07142857142857142
2057	1498	31	2	0	33	2	0.06060606060606061
2058	1497	36	0	0	36	0	0
2059	1520	32	0	0	32	0	0
206	1525	28	0	0	28	0	0
2060	1502	32	0	0	32	0	0
2061	1515	29	0	0	29	0	0
2062	1514	40	1	0	41	1	0.024390243902439025
2063	1524	21	0	0	21	0	0
2064	1501	27	0	0	27	0	0
2065	1488	33	0	0	33	0	0
2066	1508	33	0	0	33	0	0
2067	1509	15	2	0	17	2	0.11764705882352941
2068	1507	22	2	0	24	2	0.08333333333333333
2069	1491	32	0	0	32	0	0
207	1502	28	0	0	28	0	0
2070	1507	24	0	0	24	0	0
2071	1505	36	1	0	37	1	0.02702702702702703
2072	1514	30	0	0	30	0	0
2073	1511	27	0	0	27	0	0
2074	1492	27	1	0	28	1	0.03571428571428571
2075	1505	36	1	0	37	1	0.02702702702702703
2076	1486	30	2	0	32	2	0.0625
2077	1494	32	1	0	33	1	0.030303030303030304
2078	1529	23	0	0	23	0	0
2079	1515	26	0	0	26	0	0
208	1527	20	2	0	22	2	0.09090909090909091
2080	1492	30	0	0	30	0	0
2081	1469	32	2	0	34	2	0.058823529411764705
2082	1502	25	1	0	26	1	0.038461538461538464
2083	1505	27	1	0	28	1	0.03571428571428571
2084	1531	27	1	0	28	1	0.03571428571428571
2085	1510	30	0	0	30	0	0
2086	1498	33	1	0	34	1	0.029411764705882353
2087	1500	32	1	0	33	1	0.030303030303030304
2088	1494	35	2	0	37	2	0.05405405405405406
2089	1537	33	1	0	34	1	0.029411764705882353
209	1523	28	0	0	28	0	0
2090	1502	28	0	0	28	0	0
2091	1501	34	2	0	36	2	0.05555555555555555
2092	1495	26	0	0	26	0	0
2093	1510	34	2	0	36	2	0.05555555555555555
2094	1530	32	1	0	33	1	0.030303030303030304
2095	1492	38	2	0	40	2	0.05
2096	1535	39	0	0	39	0	0
2097	1512	20	1	0	21	1	0.047619047619047616
2098	1484	32	1	0	33	1	0.030303030303030304
2099	1521	24	2	0	26	2	0.07692307692307693
21	1492	30	0	0	30	0	0
210	1509	28	2	0	30	2	0.06666666666666667
2100	1506	17	1	0	18	1	0.05555555555555555
2101	1486	28	1	0	29	1	0.034482758620689655
2102	1504	36	1	0	37	1	0.02702702702702703
2103	1499	35	0	0	35	0	0
2104	1516	28	0	0	28	0	0
2105	1506	32	1	0	33	1	0.030303030303030304
2106	1542	21	1	0	22	1	0.045454545454545456
2107	1505	33	1	0	34	1	0.029411764705882353
2108	1518	28	3	0	31	3	0.0967741935483871
2109	1518	32	0	0	32	0	0
211	1501	24	2	0	26	2	0.07692307692307693
2110	1518	27	0	0	27	0	0
2111	1531	28	0	0	28	0	0
2112	1511	27	1	0	28	1	0.03571428571428571
2113	1511	27	2	0	29	2	0.06896551724137931
2114	1494	25	2	0	27	2	0.07407407407407407
2115	1482	26	2	0	28	2	0.07142857142857142
2116	1485	36	0	0	36	0	0
2117	1493	18	1	0	19	1	0.05263157894736842
2118	1500	34	1	0	35	1	0.02857142857142857
2119	1523	24	1	0	25	1	0.04
212	1509	24	1	0	25	1	0.04
2120	1516	40	5	0	45	5	0.1111111111111111
2121	1522	33	1	0	34	1	0.029411764705882353
2122	1497	41	0	0	41	0	0
2123	1563	24	0	0	24	0	0
2124	1495	34	1	0	35	1	0.02857142857142857
2125	1508	35	1	0	36	1	0.027777777777777776
2126	1473	29	1	0	30	1	0.03333333333333333
2127	1474	30	0	0	30	0	0
2128	1528	36	3	0	39	3	0.07692307692307693
2129	1508	46	0	0	46	0	0
213	1537	30	0	0	30	0	0
2130	1533	30	1	0	31	1	0.03225806451612903
2131	1519	24	1	0	25	1	0.04
2132	1525	27	0	0	27	0	0
2133	1504	32	0	0	32	0	0
2134	1522	30	1	0	31	1	0.03225806451612903
2135	1512	34	0	0	34	0	0
2136	1511	21	1	0	22	1	0.045454545454545456
2137	1487	28	0	0	28	0	0
2138	1509	24	0	0	24	0	0
2139	1500	30	1	0	31	1	0.03225806451612903
214	1526	37	2	0	39	2	0.05128205128205128
2140	1524	42	1	0	43	1	0.023255813953488372
2141	1518	30	0	0	30	0	0
2142	1523	33	3	0	36	3	0.08333333333333333
2143	1531	25	0	0	25	0	0
2144	1512	37	4	0	41	4	0.0975609756097561
2145	1510	39	2	0	41	2	0.04878048780487805
2146	1491	28	0	0	28	0	0
2147	1535	28	1	0	29	1	0.034482758620689655
2148	1524	43	0	0	43	0	0
2149	1499	41	1	0	42	1	0.023809523809523808
215	1507	24	0	0	24	0	0
2150	1494	36	0	0	36	0	0
2151	1489	27	2	0	29	2	0.06896551724137931
2152	1505	39	2	0	41	2	0.04878048780487805
2153	1517	26	0	0	26	0	0
2154	1499	27	3	0	30	3	0.1
2155	1527	32	1	0	33	1	0.030303030303030304
2156	1521	27	0	0	27	0	0
2157	1534	30	0	0	30	0	0
2158	1532	22	1	0	23	1	0.043478260869565216
2159	1471	24	2	0	26	2	0.07692307692307693
216	1495	27	2	0	29	2	0.06896551724137931
2160	1499	33	1	0	34	1	0.029411764705882353
2161	1510	25	0	0	25	0	0
2162	1529	31	2	0	33	2	0.06060606060606061
2163	1501	39	0	0	39	0	0
2164	1506	29	0	0	29	0	0
2165	1514	29	0	0	29	0	0
2166	1509	33	1	0	34	1	0.029411764705882353
2167	1553	30	3	0	33	3	0.09090909090909091
2168	1457	35	2	0	37	2	0.05405405405405406
2169	1504	29	1	0	30	1	0.03333333333333333
217	1504	25	1	0	26	1	0.038461538461538464
2170	1505	36	1	0	37	1	0.02702702702702703
2171	1509	39	0	0	39	0	0
2172	1492	35	0	0	35	0	0
2173	1522	30	2	0	32	2	0.0625
2174	1483	25	0	0	25	0	0
2175	1515	32	1	0	33	1	0.030303030303030304
2176	1512	39	0	0	39	0	0
2177	1522	28	1	0	29	1	0.034482758620689655
2178	1503	32	2	0	34	2	0.058823529411764705
2179	1466	26	3	0	29	3	0.10344827586206896
218	1501	39	0	0	39	0	0
2180	1501	39	1	0	40	1	0.025
2181	1500	21	1	0	22	1	0.045454545454545456
2182	1508	27	1	0	28	1	0.03571428571428571
2183	1484	29	1	1	31	2	0.06451612903225806
2184	1494	36	0	0	36	0	0
2185	1505	33	1	0	34	1	0.029411764705882353
2186	1501	19	0	0	19	0	0
2187	1495	25	1	0	26	1	0.038461538461538464
2188	1507	25	1	0	26	1	0.038461538461538464
2189	1517	31	3	0	34	3	0.08823529411764706
219	1489	29	2	0	31	2	0.06451612903225806
2190	1487	39	1	0	40	1	0.025
2191	1531	33	1	0	34	1	0.029411764705882353
2192	1519	29	1	0	30	1	0.03333333333333333
2193	1544	28	0	1	29	1	0.034482758620689655
2194	1501	28	1	0	29	1	0.034482758620689655
2195	1465	25	0	0	25	0	0
2196	1529	31	3	0	34	3	0.08823529411764706
2197	1547	22	1	0	23	1	0.043478260869565216
2198	1506	20	1	0	21	1	0.047619047619047616
2199	1533	27	2	0	29	2	0.06896551724137931
22	1515	32	0	0	32	0	0
220	1508	23	1	0	24	1	0.041666666666666664
2200	1498	39	0	0	39	0	0
2201	1529	43	1	0	44	1	0.022727272727272728
2202	1470	34	1	0	35	1	0.02857142857142857
2203	1526	37	2	0	39	2	0.05128205128205128
2204	1503	30	0	0	30	0	0
2205	1530	44	2	0	46	2	0.043478260869565216
2206	1528	36	0	0	36	0	0
2207	1471	27	2	0	29	2	0.06896551724137931
2208	1525	29	0	0	29	0	0
2209	1520	35	0	0	35	0	0
221	1537	27	2	0	29	2	0.06896551724137931
2210	1493	40	0	0	40	0	0
2211	1461	20	0	0	20	0	0
2212	1514	24	3	0	27	3	0.1111111111111111
2213	1495	36	1	0	37	1	0.02702702702702703
2214	1526	35	0	0	35	0	0
2215	1505	28	1	0	29	1	0.034482758620689655
2216	1524	38	0	1	39	1	0.02564102564102564
2217	1502	27	1	0	28	1	0.03571428571428571
2218	1520	44	2	0	46	2	0.043478260869565216
2219	1503	30	0	0	30	0	0
222	1514	33	1	0	34	1	0.029411764705882353
2220	1516	22	1	0	23	1	0.043478260869565216
2221	1508	28	1	0	29	1	0.034482758620689655
2222	1488	27	2	0	29	2	0.06896551724137931
2223	1488	34	4	0	38	4	0.10526315789473684
2224	1508	27	1	0	28	1	0.03571428571428571
2225	1524	33	0	0	33	0	0
2226	1518	22	1	0	23	1	0.043478260869565216
2227	1502	25	1	0	26	1	0.038461538461538464
2228	1503	38	0	0	38	0	0
2229	1549	35	0	0	35	0	0
223	1486	39	0	0	39	0	0
2230	1534	32	0	0	32	0	0
2231	1507	32	2	0	34	2	0.058823529411764705
2232	1497	39	1	0	40	1	0.025
2233	1491	32	1	0	33	1	0.030303030303030304
2234	1501	27	0	0	27	0	0
2235	1493	29	1	0	30	1	0.03333333333333333
2236	1502	20	1	0	21	1	0.047619047619047616
2237	1509	32	0	0	32	0	0
2238	1524	25	1	0	26	1	0.038461538461538464
2239	1504	31	0	0	31	0	0
224	1528	28	1	0	29	1	0.034482758620689655
2240	1519	32	0	0	32	0	0
2241	1548	37	3	0	40	3	0.075
2242	1500	36	0	0	36	0	0
2243	1509	27	0	0	27	0	0
2244	1515	27	2	0	29	2	0.06896551724137931
2245	1499	37	1	0	38	1	0.02631578947368421
2246	1491	38	1	0	39	1	0.02564102564102564
2247	1492	31	0	0	31	0	0
2248	1511	25	0	0	25	0	0
2249	1507	35	3	0	38	3	0.07894736842105263
225	1458	29	2	0	31	2	0.06451612903225806
2250	1514	32	0	0	32	0	0
2251	1526	33	1	0	34	1	0.029411764705882353
2252	1529	32	1	0	33	1	0.030303030303030304
2253	1485	26	1	0	27	1	0.037037037037037035
2254	1512	20	4	0	24	4	0.16666666666666666
2255	1538	35	0	0	35	0	0
2256	1513	22	2	0	24	2	0.08333333333333333
2257	1520	36	0	0	36	0	0
2258	1508	28	1	0	29	1	0.034482758620689655
2259	1505	34	1	0	35	1	0.02857142857142857
226	1527	38	2	0	40	2	0.05
2260	1552	28	1	0	29	1	0.034482758620689655
2261	1512	34	3	0	37	3	0.08108108108108109
2262	1511	34	1	0	35	1	0.02857142857142857
2263	1558	30	0	0	30	0	0
2264	1499	29	2	0	31	2	0.06451612903225806
2265	1493	26	2	0	28	2	0.07142857142857142
2266	1486	30	1	0	31	1	0.03225806451612903
2267	1519	39	0	0	39	0	0
2268	1491	36	1	0	37	1	0.02702702702702703
2269	1514	25	1	0	26	1	0.038461538461538464
227	1492	23	0	0	23	0	0
2270	1519	28	0	0	28	0	0
2271	1496	28	2	0	30	2	0.06666666666666667
2272	1506	31	2	0	33	2	0.06060606060606061
2273	1524	30	2	0	32	2	0.0625
2274	1515	29	1	0	30	1	0.03333333333333333
2275	1531	29	0	0	29	0	0
2276	1478	23	0	0	23	0	0
2277	1497	32	0	0	32	0	0
2278	1505	29	3	0	32	3	0.09375
2279	1511	31	2	0	33	2	0.06060606060606061
228	1528	36	1	0	37	1	0.02702702702702703
2280	1522	25	1	0	26	1	0.038461538461538464
2281	1518	23	1	0	24	1	0.041666666666666664
2282	1489	28	1	0	29	1	0.034482758620689655
2283	1474	38	0	0	38	0	0
2284	1526	30	3	0	33	3	0.09090909090909091
2285	1511	24	0	0	24	0	0
2286	1530	31	2	0	33	2	0.06060606060606061
2287	1500	20	3	0	23	3	0.13043478260869565
2288	1503	27	0	0	27	0	0
2289	1520	31	2	0	33	2	0.06060606060606061
229	1546	27	0	0	27	0	0
2290	1530	34	0	0	34	0	0
2291	1474	33	1	0	34	1	0.029411764705882353
2292	1520	39	0	0	39	0	0
2293	1502	30	1	1	32	2	0.0625
2294	1481	30	1	0	31	1	0.03225806451612903
2295	1528	21	0	0	21	0	0
2296	1489	33	0	0	33	0	0
2297	1509	24	0	0	24	0	0
2298	1482	31	0	0	31	0	0
2299	1490	42	2	0	44	2	0.045454545454545456
23	1517	35	0	0	35	0	0
230	1538	37	1	0	38	1	0.02631578947368421
2300	1522	30	2	0	32	2	0.0625
2301	1490	37	1	0	38	1	0.02631578947368421
2302	1523	34	1	0	35	1	0.02857142857142857
2303	1539	29	0	0	29	0	0
2304	1503	30	0	0	30	0	0
2305	1494	26	0	0	26	0	0
2306	1508	32	1	0	33	1	0.030303030303030304
2307	1536	43	0	0	43	0	0
2308	1504	29	0	0	29	0	0
2309	1515	28	2	0	30	2	0.06666666666666667
231	1511	36	0	0	36	0	0
2310	1542	30	0	0	30	0	0
2311	1505	32	0	0	32	0	0
2312	1543	23	1	0	24	1	0.041666666666666664
2313	1538	26	1	0	27	1	0.037037037037037035
2314	1531	29	0	0	29	0	0
2315	1481	30	2	0	32	2	0.0625
2316	1502	34	1	0	35	1	0.02857142857142857
2317	1524	31	2	0	33	2	0.06060606060606061
2318	1504	23	0	0	23	0	0
2319	1501	41	0	0	41	0	0
232	1548	25	2	0	27	2	0.07407407407407407
2320	1511	37	0	0	37	0	0
2321	1525	32	3	0	35	3	0.08571428571428572
2322	1497	20	0	0	20	0	0
2323	1521	39	1	0	40	1	0.025
2324	1500	30	1	0	31	1	0.03225806451612903
2325	1513	23	0	0	23	0	0
2326	1491	26	2	0	28	2	0.07142857142857142
2327	1527	31	0	0	31	0	0
2328	1517	42	0	0	42	0	0
2329	1523	29	1	0	30	1	0.03333333333333333
233	1492	35	3	0	38	3	0.07894736842105263
2330	1549	23	0	0	23	0	0
2331	1506	32	0	0	32	0	0
2332	1529	37	1	0	38	1	0.02631578947368421
2333	1494	32	1	0	33	1	0.030303030303030304
2334	1512	38	1	0	39	1	0.02564102564102564
2335	1524	35	1	0	36	1	0.027777777777777776
2336	1531	25	0	0	25	0	0
2337	1508	35	1	0	36	1	0.027777777777777776
2338	1515	28	0	0	28	0	0
2339	1493	44	0	0	44	0	0
234	1524	35	0	0	35	0	0
2340	1484	34	0	0	34	0	0
2341	1526	18	1	0	19	1	0.05263157894736842
2342	1536	26	3	0	29	3	0.10344827586206896
2343	1550	24	2	0	26	2	0.07692307692307693
2344	1556	27	2	0	29	2	0.06896551724137931
2345	1568	29	1	0	30	1	0.03333333333333333
2346	1512	26	0	0	26	0	0
2347	1511	35	0	0	35	0	0
2348	1505	31	0	0	31	0	0
2349	1490	29	1	0	30	1	0.03333333333333333
235	1483	33	1	0	34	1	0.029411764705882353
2350	1509	42	1	0	43	1	0.023255813953488372
2351	1532	24	1	0	25	1	0.04
2352	1550	29	2	0	31	2	0.06451612903225806
2353	1507	29	1	0	30	1	0.03333333333333333
2354	1509	28	0	0	28	0	0
2355	1527	32	0	0	32	0	0
2356	1488	29	0	0	29	0	0
2357	1494	28	1	1	30	2	0.06666666666666667
2358	1513	28	0	0	28	0	0
2359	1525	40	4	0	44	4	0.09090909090909091
236	1507	37	1	0	38	1	0.02631578947368421
2360	1514	37	2	0	39	2	0.05128205128205128
2361	1519	24	0	0	24	0	0
2362	1495	31	0	0	31	0	0
2363	1516	24	2	0	26	2	0.07692307692307693
2364	1537	31	1	0	32	1	0.03125
2365	1490	28	1	0	29	1	0.034482758620689655
2366	1514	36	0	0	36	0	0
2367	1562	28	3	0	31	3	0.0967741935483871
2368	1508	30	2	0	32	2	0.0625
2369	1519	30	2	0	32	2	0.0625
237	1502	35	1	0	36	1	0.027777777777777776
2370	1520	31	1	0	32	1	0.03125
2371	1509	25	2	0	27	2	0.07407407407407407
2372	1512	42	2	0	44	2	0.045454545454545456
2373	1545	28	1	0	29	1	0.034482758620689655
2374	1524	28	0	0	28	0	0
2375	1506	28	1	0	29	1	0.034482758620689655
2376	1529	28	1	0	29	1	0.034482758620689655
2377	1536	31	0	0	31	0	0
2378	1521	40	0	0	40	0	0
2379	1532	27	0	0	27	0	0
238	1490	33	2	0	35	2	0.05714285714285714
2380	1503	24	1	0	25	1	0.04
2381	1501	31	0	0	31	0	0
2382	1499	38	2	0	40	2	0.05
2383	1515	36	0	0	36	0	0
2384	1518	29	1	0	30	1	0.03333333333333333
2385	1500	31	0	0	31	0	0
2386	1512	31	0	0	31	0	0
2387	1510	20	1	0	21	1	0.047619047619047616
2388	1524	33	0	0	33	0	0
2389	1511	32	1	0	33	1	0.030303030303030304
239	1503	32	1	0	33	1	0.030303030303030304
2390	1541	32	2	0	34	2	0.058823529411764705
2391	1477	26	1	0	27	1	0.037037037037037035
2392	1510	30	0	0	30	0	0
2393	1488	28	1	0	29	1	0.034482758620689655
2394	1490	44	0	0	44	0	0
2395	1528	29	0	0	29	0	0
2396	1544	20	2	0	22	2	0.09090909090909091
2397	1550	23	2	0	25	2	0.08
2398	1488	21	1	0	22	1	0.045454545454545456
2399	1482	25	2	0	27	2	0.07407407407407407
24	1528	31	2	0	33	2	0.06060606060606061
240	1520	26	1	0	27	1	0.037037037037037035
2400	1499	28	0	0	28	0	0
2401	1482	35	0	0	35	0	0
2402	1551	38	0	0	38	0	0
2403	1518	35	2	0	37	2	0.05405405405405406
2404	1503	37	3	0	40	3	0.075
2405	1478	22	0	0	22	0	0
2406	1509	34	5	0	39	5	0.1282051282051282
2407	1516	18	1	0	19	1	0.05263157894736842
2408	1540	30	0	0	30	0	0
2409	1513	29	0	0	29	0	0
241	1483	29	1	0	30	1	0.03333333333333333
2410	1517	36	0	0	36	0	0
2411	1517	30	0	0	30	0	0
2412	1535	33	1	0	34	1	0.029411764705882353
2413	1507	35	0	0	35	0	0
2414	1506	30	0	0	30	0	0
2415	1508	23	0	0	23	0	0
2416	1520	30	2	0	32	2	0.0625
2417	1510	20	0	0	20	0	0
2418	1502	29	1	0	30	1	0.03333333333333333
2419	1498	29	1	0	30	1	0.03333333333333333
242	1505	31	2	0	33	2	0.06060606060606061
2420	1485	29	0	0	29	0	0
2421	1499	38	1	0	39	1	0.02564102564102564
2422	1508	33	0	0	33	0	0
2423	1507	27	0	0	27	0	0
2424	1497	31	1	0	32	1	0.03125
2425	1562	26	0	0	26	0	0
2426	1509	24	0	0	24	0	0
2427	1537	32	2	0	34	2	0.058823529411764705
2428	1509	26	2	0	28	2	0.07142857142857142
2429	1551	37	0	0	37	0	0
243	1509	31	0	0	31	0	0
2430	1499	39	1	0	40	1	0.025
2431	1539	38	1	0	39	1	0.02564102564102564
2432	1522	29	2	0	31	2	0.06451612903225806
2433	1523	33	1	0	34	1	0.029411764705882353
2434	1525	25	2	0	27	2	0.07407407407407407
2435	1520	28	0	0	28	0	0
2436	1484	42	0	0	42	0	0
2437	1496	37	1	0	38	1	0.02631578947368421
2438	1504	37	0	0	37	0	0
2439	1539	21	0	0	21	0	0
244	1494	29	1	0	30	1	0.03333333333333333
2440	1481	28	0	0	28	0	0
2441	1493	31	0	0	31	0	0
2442	1488	38	1	0	39	1	0.02564102564102564
2443	1503	21	0	0	21	0	0
2444	1530	30	5	0	35	5	0.14285714285714285
2445	1507	27	1	0	28	1	0.03571428571428571
2446	1513	29	1	0	30	1	0.03333333333333333
2447	1524	35	1	0	36	1	0.027777777777777776
2448	1505	32	1	0	33	1	0.030303030303030304
2449	1536	32	5	0	37	5	0.13513513513513514
245	1524	27	1	0	28	1	0.03571428571428571
2450	1499	35	0	1	36	1	0.027777777777777776
2451	1514	32	1	0	33	1	0.030303030303030304
2452	1539	29	0	0	29	0	0
2453	1496	39	0	0	39	0	0
2454	1489	26	0	0	26	0	0
2455	1529	34	1	0	35	1	0.02857142857142857
2456	1528	24	1	0	25	1	0.04
2457	1504	24	0	0	24	0	0
2458	1536	25	3	0	28	3	0.10714285714285714
2459	1478	27	1	0	28	1	0.03571428571428571
246	1510	27	1	0	28	1	0.03571428571428571
2460	1497	34	0	0	34	0	0
2461	1490	29	3	0	32	3	0.09375
2462	1516	31	0	0	31	0	0
2463	1508	37	0	0	37	0	0
2464	1536	33	1	0	34	1	0.029411764705882353
2465	1509	33	0	0	33	0	0
2466	1504	34	2	0	36	2	0.05555555555555555
2467	1503	26	1	0	27	1	0.037037037037037035
2468	1526	33	1	0	34	1	0.029411764705882353
2469	1493	30	1	0	31	1	0.03225806451612903
247	1516	32	1	0	33	1	0.030303030303030304
2470	1479	27	1	0	28	1	0.03571428571428571
2471	1500	36	1	0	37	1	0.02702702702702703
2472	1498	33	1	0	34	1	0.029411764705882353
2473	1515	28	0	0	28	0	0
2474	1537	32	1	0	33	1	0.030303030303030304
2475	1510	32	1	0	33	1	0.030303030303030304
2476	1517	28	0	0	28	0	0
2477	1519	25	1	0	26	1	0.038461538461538464
2478	1496	34	0	0	34	0	0
2479	1500	38	0	0	38	0	0
248	1527	23	1	0	24	1	0.041666666666666664
2480	1513	40	2	0	42	2	0.047619047619047616
2481	1531	29	2	0	31	2	0.06451612903225806
2482	1498	26	2	0	28	2	0.07142857142857142
2483	1521	29	1	0	30	1	0.03333333333333333
2484	1511	26	0	0	26	0	0
2485	1489	29	1	0	30	1	0.03333333333333333
2486	1495	29	3	0	32	3	0.09375
2487	1498	25	1	0	26	1	0.038461538461538464
2488	1510	20	0	0	20	0	0
2489	1547	27	1	0	28	1	0.03571428571428571
249	1500	30	1	0	31	1	0.03225806451612903
2490	1512	25	1	0	26	1	0.038461538461538464
2491	1504	32	1	0	33	1	0.030303030303030304
2492	1484	32	1	0	33	1	0.030303030303030304
2493	1490	35	1	0	36	1	0.027777777777777776
2494	1517	23	0	0	23	0	0
2495	1497	20	1	0	21	1	0.047619047619047616
2496	1533	33	2	0	35	2	0.05714285714285714
2497	1504	30	0	0	30	0	0
2498	1500	42	1	0	43	1	0.023255813953488372
2499	1520	33	2	0	35	2	0.05714285714285714
25	1534	21	1	0	22	1	0.045454545454545456
250	1535	26	0	0	26	0	0
2500	1507	31	0	0	31	0	0
2501	1510	27	0	0	27	0	0
2502	1521	27	1	0	28	1	0.03571428571428571
2503	1487	35	0	0	35	0	0
2504	1509	39	1	0	40	1	0.025
2505	1501	34	1	0	35	1	0.02857142857142857
2506	1498	21	2	0	23	2	0.08695652173913043
2507	1530	32	2	0	34	2	0.058823529411764705
2508	1552	21	0	0	21	0	0
2509	1514	39	1	0	40	1	0.025
251	1490	31	0	0	31	0	0
2510	1494	31	0	0	31	0	0
2511	1524	50	1	0	51	1	0.0196078431372549
2512	1475	37	1	0	38	1	0.02631578947368421
2513	1526	38	0	0	38	0	0
2514	1509	20	2	0	22	2	0.09090909090909091
2515	1513	23	2	0	25	2	0.08
2516	1547	30	0	0	30	0	0
2517	1553	25	3	0	28	3	0.10714285714285714
2518	1518	32	1	0	33	1	0.030303030303030304
2519	1513	47	1	0	48	1	0.020833333333333332
252	1487	23	1	0	24	1	0.041666666666666664
2520	1484	27	1	0	28	1	0.03571428571428571
2521	1517	32	0	0	32	0	0
2522	1503	34	1	0	35	1	0.02857142857142857
2523	1517	37	2	0	39	2	0.05128205128205128
2524	1481	33	1	0	34	1	0.029411764705882353
2525	1511	26	0	0	26	0	0
2526	1464	26	1	0	27	1	0.037037037037037035
2527	1506	27	0	0	27	0	0
2528	1519	34	0	0	34	0	0
2529	1551	35	1	0	36	1	0.027777777777777776
253	1504	40	0	0	40	0	0
2530	1499	32	2	0	34	2	0.058823529411764705
2531	1533	30	1	0	31	1	0.03225806451612903
2532	1512	28	1	0	29	1	0.034482758620689655
2533	1514	38	2	0	40	2	0.05
2534	1506	32	0	0	32	0	0
2535	1484	20	2	0	22	2	0.09090909090909091
2536	1536	27	0	0	27	0	0
2537	1510	26	0	0	26	0	0
2538	1512	38	1	0	39	1	0.02564102564102564
2539	1524	34	2	0	36	2	0.05555555555555555
254	1552	28	1	0	29	1	0.034482758620689655
2540	1493	32	2	0	34	2	0.058823529411764705
2541	1502	35	1	0	36	1	0.027777777777777776
2542	1525	42	0	0	42	0	0
2543	1517	26	0	0	26	0	0
2544	1515	42	0	0	42	0	0
2545	1488	32	1	0	33	1	0.030303030303030304
2546	1513	19	0	0	19	0	0
2547	1519	25	0	1	26	1	0.038461538461538464
2548	1520	38	2	0	40	2	0.05
2549	1515	29	0	0	29	0	0
255	1520	25	2	0	27	2	0.07407407407407407
2550	1514	27	3	0	30	3	0.1
2551	1503	35	0	0	35	0	0
2552	1516	37	0	0	37	0	0
2553	1525	31	1	0	32	1	0.03125
2554	1481	35	0	0	35	0	0
2555	1492	35	2	1	38	3	0.07894736842105263
2556	1510	21	0	0	21	0	0
2557	1491	34	2	0	36	2	0.05555555555555555
2558	1508	27	0	0	27	0	0
2559	1500	43	1	0	44	1	0.022727272727272728
256	1550	26	1	0	27	1	0.037037037037037035
2560	1507	28	2	0	30	2	0.06666666666666667
2561	1505	33	1	0	34	1	0.029411764705882353
2562	1533	26	0	0	26	0	0
2563	1522	39	1	0	40	1	0.025
2564	1487	27	0	0	27	0	0
2565	1489	35	1	0	36	1	0.027777777777777776
2566	1508	25	1	0	26	1	0.038461538461538464
2567	1530	32	0	0	32	0	0
2568	1530	25	3	0	28	3	0.10714285714285714
2569	1520	35	0	0	35	0	0
257	1549	29	2	0	31	2	0.06451612903225806
2570	1507	38	1	0	39	1	0.02564102564102564
2571	1529	17	1	0	18	1	0.05555555555555555
2572	1514	28	1	0	29	1	0.034482758620689655
2573	1542	39	0	0	39	0	0
2574	1495	25	1	0	26	1	0.038461538461538464
2575	1491	39	0	0	39	0	0
2576	1524	35	1	0	36	1	0.027777777777777776
2577	1479	36	0	0	36	0	0
2578	1552	26	0	0	26	0	0
2579	1493	36	1	0	37	1	0.02702702702702703
258	1507	30	1	0	31	1	0.03225806451612903
2580	1531	36	2	0	38	2	0.05263157894736842
2581	1509	27	0	0	27	0	0
2582	1471	36	0	0	36	0	0
2583	1495	23	0	0	23	0	0
2584	1487	36	1	0	37	1	0.02702702702702703
2585	1531	32	0	0	32	0	0
2586	1527	27	1	0	28	1	0.03571428571428571
2587	1531	32	1	0	33	1	0.030303030303030304
2588	1466	34	0	0	34	0	0
2589	1528	28	4	0	32	4	0.125
259	1467	30	0	0	30	0	0
2590	1527	35	1	0	36	1	0.027777777777777776
2591	1482	33	0	0	33	0	0
2592	1495	32	0	0	32	0	0
2593	1500	33	0	0	33	0	0
2594	1537	29	0	0	29	0	0
2595	1510	30	0	0	30	0	0
2596	1531	47	1	0	48	1	0.020833333333333332
2597	1457	34	2	0	36	2	0.05555555555555555
2598	1521	35	2	0	37	2	0.05405405405405406
2599	1469	30	0	0	30	0	0
26	1527	37	1	0	38	1	0.02631578947368421
260	1512	27	0	0	27	0	0
2600	1489	30	0	0	30	0	0
2601	1510	36	1	0	37	1	0.02702702702702703
2602	1502	26	0	0	26	0	0
2603	1510	27	2	0	29	2	0.06896551724137931
2604	1546	34	1	0	35	1	0.02857142857142857
2605	1514	36	1	0	37	1	0.02702702702702703
2606	1518	36	0	0	36	0	0
2607	1498	37	2	0	39	2	0.05128205128205128
2608	1462	27	1	0	28	1	0.03571428571428571
2609	1510	28	0	0	28	0	0
261	1519	26	1	0	27	1	0.037037037037037035
2610	1500	30	3	0	33	3	0.09090909090909091
2611	1510	33	1	0	34	1	0.029411764705882353
2612	1537	30	2	0	32	2	0.0625
2613	1536	32	0	0	32	0	0
2614	1548	27	2	0	29	2	0.06896551724137931
2615	1547	32	2	0	34	2	0.058823529411764705
2616	1485	21	0	0	21	0	0
2617	1502	26	1	0	27	1	0.037037037037037035
2618	1518	39	1	0	40	1	0.025
2619	1502	39	3	0	42	3	0.07142857142857142
262	1506	38	0	0	38	0	0
2620	1537	28	0	0	28	0	0
2621	1496	36	0	0	36	0	0
2622	1527	30	0	0	30	0	0
2623	1475	30	0	0	30	0	0
2624	1511	22	1	0	23	1	0.043478260869565216
2625	1543	31	0	0	31	0	0
2626	1515	37	0	0	37	0	0
2627	1521	24	0	0	24	0	0
2628	1569	29	1	0	30	1	0.03333333333333333
2629	1507	27	1	0	28	1	0.03571428571428571
263	1512	33	3	0	36	3	0.08333333333333333
2630	1516	32	2	0	34	2	0.058823529411764705
2631	1506	29	0	0	29	0	0
2632	1506	25	0	0	25	0	0
2633	1470	34	0	0	34	0	0
2634	1524	29	0	0	29	0	0
2635	1513	32	0	0	32	0	0
2636	1530	28	3	0	31	3	0.0967741935483871
2637	1537	19	2	0	21	2	0.09523809523809523
2638	1515	37	2	0	39	2	0.05128205128205128
2639	1511	22	2	0	24	2	0.08333333333333333
264	1544	40	2	0	42	2	0.047619047619047616
2640	1478	34	1	0	35	1	0.02857142857142857
2641	1519	23	2	0	25	2	0.08
2642	1518	32	0	0	32	0	0
2643	1497	28	0	0	28	0	0
2644	1536	30	2	0	32	2	0.0625
2645	1511	28	0	0	28	0	0
2646	1509	24	1	0	25	1	0.04
2647	1521	28	1	0	29	1	0.034482758620689655
2648	1474	23	1	0	24	1	0.041666666666666664
2649	1522	28	1	0	29	1	0.034482758620689655
265	1508	31	2	0	33	2	0.06060606060606061
2650	1500	22	0	0	22	0	0
2651	1529	31	1	0	32	1	0.03125
2652	1510	35	2	0	37	2	0.05405405405405406
2653	1522	30	0	0	30	0	0
2654	1493	23	0	0	23	0	0
2655	1540	29	1	0	30	1	0.03333333333333333
2656	1507	26	3	0	29	3	0.10344827586206896
2657	1566	25	4	0	29	4	0.13793103448275862
2658	1492	25	1	0	26	1	0.038461538461538464
2659	1518	35	2	0	37	2	0.05405405405405406
266	1521	25	0	0	25	0	0
2660	1529	25	1	0	26	1	0.038461538461538464
2661	1478	34	2	0	36	2	0.05555555555555555
2662	1513	39	2	0	41	2	0.04878048780487805
2663	1495	30	1	0	31	1	0.03225806451612903
2664	1506	28	1	0	29	1	0.034482758620689655
2665	1564	24	1	0	25	1	0.04
2666	1508	30	0	0	30	0	0
2667	1512	26	3	0	29	3	0.10344827586206896
2668	1499	21	0	0	21	0	0
2669	1495	26	0	0	26	0	0
267	1512	24	2	0	26	2	0.07692307692307693
2670	1538	26	1	0	27	1	0.037037037037037035
2671	1512	33	1	0	34	1	0.029411764705882353
2672	1524	37	2	0	39	2	0.05128205128205128
2673	1528	35	3	0	38	3	0.07894736842105263
2674	1509	31	0	0	31	0	0
2675	1498	39	1	0	40	1	0.025
2676	1516	32	2	0	34	2	0.058823529411764705
2677	1523	37	0	0	37	0	0
2678	1507	29	0	0	29	0	0
2679	1530	28	0	0	28	0	0
268	1543	32	1	0	33	1	0.030303030303030304
2680	1505	26	1	0	27	1	0.037037037037037035
2681	1547	31	1	0	32	1	0.03125
2682	1532	19	0	0	19	0	0
2683	1516	26	0	0	26	0	0
2684	1499	29	1	0	30	1	0.03333333333333333
2685	1522	25	1	0	26	1	0.038461538461538464
2686	1500	34	0	0	34	0	0
2687	1509	41	0	0	41	0	0
2688	1507	33	3	0	36	3	0.08333333333333333
2689	1507	29	0	0	29	0	0
269	1502	41	1	0	42	1	0.023809523809523808
2690	1490	40	1	0	41	1	0.024390243902439025
2691	1497	36	1	0	37	1	0.02702702702702703
2692	1515	36	1	0	37	1	0.02702702702702703
2693	1504	39	1	0	40	1	0.025
2694	1482	28	3	0	31	3	0.0967741935483871
2695	1493	31	0	0	31	0	0
2696	1506	28	1	0	29	1	0.034482758620689655
2697	1540	22	1	0	23	1	0.043478260869565216
2698	1499	26	1	0	27	1	0.037037037037037035
2699	1485	31	0	0	31	0	0
27	1519	38	2	0	40	2	0.05
270	1523	27	0	0	27	0	0
2700	1533	35	0	0	35	0	0
2701	1527	33	0	0	33	0	0
2702	1493	39	2	0	41	2	0.04878048780487805
2703	1481	35	2	0	37	2	0.05405405405405406
2704	1550	29	1	0	30	1	0.03333333333333333
2705	1518	22	0	0	22	0	0
2706	1502	34	2	0	36	2	0.05555555555555555
2707	1488	17	2	0	19	2	0.10526315789473684
2708	1526	24	3	0	27	3	0.1111111111111111
2709	1515	33	3	0	36	3	0.08333333333333333
271	1502	21	1	0	22	1	0.045454545454545456
2710	1490	38	2	0	40	2	0.05
2711	1488	37	0	0	37	0	0
2712	1494	28	1	0	29	1	0.034482758620689655
2713	1507	20	1	0	21	1	0.047619047619047616
2714	1522	31	3	0	34	3	0.08823529411764706
2715	1498	35	4	0	39	4	0.10256410256410256
2716	1492	30	0	1	31	1	0.03225806451612903
2717	1496	29	1	0	30	1	0.03333333333333333
2718	1494	24	1	0	25	1	0.04
2719	1467	27	2	0	29	2	0.06896551724137931
272	1499	33	1	0	34	1	0.029411764705882353
2720	1511	25	0	0	25	0	0
2721	1525	31	1	0	32	1	0.03125
2722	1516	24	0	0	24	0	0
2723	1494	26	1	0	27	1	0.037037037037037035
2724	1504	33	0	0	33	0	0
2725	1522	28	0	0	28	0	0
2726	1524	18	1	0	19	1	0.05263157894736842
2727	1517	33	2	0	35	2	0.05714285714285714
2728	1500	21	1	0	22	1	0.045454545454545456
2729	1534	23	0	0	23	0	0
273	1521	32	2	0	34	2	0.058823529411764705
2730	1514	31	3	0	34	3	0.08823529411764706
2731	1536	28	1	0	29	1	0.034482758620689655
2732	1491	40	2	0	42	2	0.047619047619047616
2733	1519	36	1	0	37	1	0.02702702702702703
2734	1497	31	3	0	34	3	0.08823529411764706
2735	1511	29	0	0	29	0	0
2736	1492	35	0	0	35	0	0
2737	1524	30	1	0	31	1	0.03225806451612903
2738	1490	31	1	0	32	1	0.03125
2739	1521	22	1	0	23	1	0.043478260869565216
274	1501	31	2	0	33	2	0.06060606060606061
2740	1505	31	4	0	35	4	0.11428571428571428
2741	1513	29	0	0	29	0	0
2742	1502	43	1	0	44	1	0.022727272727272728
2743	1512	30	1	0	31	1	0.03225806451612903
2744	1522	19	1	1	21	2	0.09523809523809523
2745	1503	29	1	0	30	1	0.03333333333333333
2746	1506	28	2	0	30	2	0.06666666666666667
2747	1492	30	1	0	31	1	0.03225806451612903
2748	1536	26	2	0	28	2	0.07142857142857142
2749	1487	32	1	0	33	1	0.030303030303030304
275	1496	32	2	0	34	2	0.058823529411764705
2750	1501	27	1	0	28	1	0.03571428571428571
2751	1517	31	0	0	31	0	0
2752	1510	45	0	0	45	0	0
2753	1541	25	2	0	27	2	0.07407407407407407
2754	1517	23	1	0	24	1	0.041666666666666664
2755	1528	35	1	0	36	1	0.027777777777777776
2756	1516	30	0	0	30	0	0
2757	1539	28	1	0	29	1	0.034482758620689655
2758	1490	32	0	0	32	0	0
2759	1511	30	1	0	31	1	0.03225806451612903
276	1495	32	4	0	36	4	0.1111111111111111
2760	1519	34	1	0	35	1	0.02857142857142857
2761	1497	39	1	0	40	1	0.025
2762	1551	32	1	0	33	1	0.030303030303030304
2763	1524	28	0	0	28	0	0
2764	1528	31	1	0	32	1	0.03125
2765	1506	25	0	0	25	0	0
2766	1513	25	1	0	26	1	0.038461538461538464
2767	1529	27	2	0	29	2	0.06896551724137931
2768	1503	23	0	0	23	0	0
2769	1497	34	0	0	34	0	0
277	1502	32	0	0	32	0	0
2770	1534	30	2	0	32	2	0.0625
2771	1512	43	0	0	43	0	0
2772	1484	34	0	0	34	0	0
2773	1457	25	1	0	26	1	0.038461538461538464
2774	1522	35	0	0	35	0	0
2775	1471	38	2	0	40	2	0.05
2776	1503	39	2	0	41	2	0.04878048780487805
2777	1544	22	0	0	22	0	0
2778	1488	30	3	0	33	3	0.09090909090909091
2779	1519	37	3	0	40	3	0.075
278	1509	28	0	0	28	0	0
2780	1524	33	0	0	33	0	0
2781	1488	31	1	0	32	1	0.03125
2782	1514	24	1	0	25	1	0.04
2783	1465	29	0	0	29	0	0
2784	1474	28	1	0	29	1	0.034482758620689655
2785	1508	28	3	0	31	3	0.0967741935483871
2786	1514	33	1	0	34	1	0.029411764705882353
2787	1536	27	0	0	27	0	0
2788	1489	30	1	0	31	1	0.03225806451612903
2789	1549	32	0	0	32	0	0
279	1521	35	0	0	35	0	0
2790	1512	37	0	0	37	0	0
2791	1549	28	0	0	28	0	0
2792	1515	27	0	0	27	0	0
2793	1510	33	0	0	33	0	0
2794	1487	37	2	0	39	2	0.05128205128205128
2795	1531	38	1	0	39	1	0.02564102564102564
2796	1515	23	0	0	23	0	0
2797	1491	31	1	0	32	1	0.03125
2798	1496	34	1	0	35	1	0.02857142857142857
2799	1531	27	0	0	27	0	0
28	1531	33	0	0	33	0	0
280	1498	37	3	0	40	3	0.075
2800	1510	34	1	0	35	1	0.02857142857142857
2801	1548	22	2	0	24	2	0.08333333333333333
2802	1515	22	1	0	23	1	0.043478260869565216
2803	1532	26	1	0	27	1	0.037037037037037035
2804	1526	32	0	0	32	0	0
2805	1508	29	0	0	29	0	0
2806	1484	21	0	0	21	0	0
2807	1507	39	1	0	40	1	0.025
2808	1493	31	0	1	32	1	0.03125
2809	1513	29	1	0	30	1	0.03333333333333333
281	1523	40	1	0	41	1	0.024390243902439025
2810	1523	28	0	0	28	0	0
2811	1490	34	3	0	37	3	0.08108108108108109
2812	1511	22	3	0	25	3	0.12
2813	1490	27	1	0	28	1	0.03571428571428571
2814	1518	30	1	0	31	1	0.03225806451612903
2815	1511	25	1	0	26	1	0.038461538461538464
2816	1527	29	0	0	29	0	0
2817	1513	39	1	0	40	1	0.025
2818	1517	35	1	0	36	1	0.027777777777777776
2819	1524	24	1	0	25	1	0.04
282	1500	32	1	0	33	1	0.030303030303030304
2820	1494	34	1	0	35	1	0.02857142857142857
2821	1511	23	0	0	23	0	0
2822	1530	34	1	0	35	1	0.02857142857142857
2823	1528	29	2	0	31	2	0.06451612903225806
2824	1498	28	0	0	28	0	0
2825	1520	24	1	0	25	1	0.04
2826	1486	31	1	0	32	1	0.03125
2827	1534	33	0	0	33	0	0
2828	1511	37	1	0	38	1	0.02631578947368421
2829	1496	29	1	0	30	1	0.03333333333333333
283	1504	29	0	0	29	0	0
2830	1530	33	0	0	33	0	0
2831	1489	28	1	0	29	1	0.034482758620689655
2832	1565	18	2	0	20	2	0.1
2833	1509	27	0	0	27	0	0
2834	1475	34	0	0	34	0	0
2835	1510	39	2	0	41	2	0.04878048780487805
2836	1533	31	1	0	32	1	0.03125
2837	1503	33	0	0	33	0	0
2838	1484	24	1	0	25	1	0.04
2839	1494	34	3	0	37	3	0.08108108108108109
284	1544	26	1	0	27	1	0.037037037037037035
2840	1479	31	1	0	32	1	0.03125
2841	1523	35	0	0	35	0	0
2842	1525	20	1	0	21	1	0.047619047619047616
2843	1494	31	2	0	33	2	0.06060606060606061
2844	1535	41	0	0	41	0	0
2845	1529	35	0	0	35	0	0
2846	1539	34	1	0	35	1	0.02857142857142857
2847	1516	29	0	0	29	0	0
2848	1477	36	1	0	37	1	0.02702702702702703
2849	1517	31	0	0	31	0	0
285	1538	16	2	0	18	2	0.1111111111111111
2850	1524	38	2	0	40	2	0.05
2851	1529	24	0	0	24	0	0
2852	1537	36	1	0	37	1	0.02702702702702703
2853	1534	32	4	0	36	4	0.1111111111111111
2854	1517	31	2	0	33	2	0.06060606060606061
2855	1537	24	1	0	25	1	0.04
2856	1490	25	0	0	25	0	0
2857	1511	27	1	0	28	1	0.03571428571428571
2858	1478	28	2	0	30	2	0.06666666666666667
2859	1520	21	0	0	21	0	0
286	1497	25	1	0	26	1	0.038461538461538464
2860	1500	20	0	0	20	0	0
2861	1498	35	1	0	36	1	0.027777777777777776
2862	1523	26	0	0	26	0	0
2863	1496	24	1	0	25	1	0.04
2864	1506	26	0	0	26	0	0
2865	1509	25	2	0	27	2	0.07407407407407407
2866	1513	44	3	0	47	3	0.06382978723404255
2867	1543	19	1	0	20	1	0.05
2868	1505	35	1	0	36	1	0.027777777777777776
2869	1534	34	0	0	34	0	0
287	1523	30	1	0	31	1	0.03225806451612903
2870	1527	27	3	0	30	3	0.1
2871	1561	28	0	0	28	0	0
2872	1520	36	1	0	37	1	0.02702702702702703
2873	1517	27	0	0	27	0	0
2874	1526	25	0	0	25	0	0
2875	1533	30	1	0	31	1	0.03225806451612903
2876	1511	24	2	0	26	2	0.07692307692307693
2877	1536	32	1	0	33	1	0.030303030303030304
2878	1552	27	0	0	27	0	0
2879	1487	25	1	0	26	1	0.038461538461538464
288	1507	25	1	0	26	1	0.038461538461538464
2880	1522	39	1	0	40	1	0.025
2881	1502	27	1	0	28	1	0.03571428571428571
2882	1475	27	1	0	28	1	0.03571428571428571
2883	1513	24	0	0	24	0	0
2884	1489	28	1	0	29	1	0.034482758620689655
2885	1506	30	0	0	30	0	0
2886	1505	30	1	0	31	1	0.03225806451612903
2887	1492	40	1	0	41	1	0.024390243902439025
2888	1541	32	1	0	33	1	0.030303030303030304
2889	1527	30	0	0	30	0	0
289	1487	24	3	0	27	3	0.1111111111111111
2890	1529	30	1	0	31	1	0.03225806451612903
2891	1527	30	0	0	30	0	0
2892	1523	34	1	0	35	1	0.02857142857142857
2893	1507	27	1	0	28	1	0.03571428571428571
2894	1491	40	0	0	40	0	0
2895	1530	28	3	0	31	3	0.0967741935483871
2896	1493	27	2	0	29	2	0.06896551724137931
2897	1493	42	1	0	43	1	0.023255813953488372
2898	1521	25	0	0	25	0	0
2899	1522	33	0	0	33	0	0
29	1527	24	1	0	25	1	0.04
290	1490	28	0	0	28	0	0
2900	1507	33	2	0	35	2	0.05714285714285714
2901	1520	41	0	0	41	0	0
2902	1529	20	1	0	21	1	0.047619047619047616
2903	1505	24	2	0	26	2	0.07692307692307693
2904	1503	28	2	0	30	2	0.06666666666666667
2905	1484	30	0	0	30	0	0
2906	1531	20	0	0	20	0	0
2907	1523	23	1	0	24	1	0.041666666666666664
2908	1539	40	1	0	41	1	0.024390243902439025
2909	1520	34	0	0	34	0	0
291	1529	33	0	0	33	0	0
2910	1518	30	0	0	30	0	0
2911	1517	25	0	0	25	0	0
2912	1485	31	0	0	31	0	0
2913	1523	22	0	0	22	0	0
2914	1526	21	0	0	21	0	0
2915	1512	30	0	0	30	0	0
2916	1525	24	0	0	24	0	0
2917	1532	33	0	0	33	0	0
2918	1503	31	2	0	33	2	0.06060606060606061
2919	1522	32	2	0	34	2	0.058823529411764705
292	1523	28	1	0	29	1	0.034482758620689655
2920	1480	23	2	0	25	2	0.08
2921	1506	40	0	0	40	0	0
2922	1504	32	0	0	32	0	0
2923	1502	32	0	0	32	0	0
2924	1516	34	1	0	35	1	0.02857142857142857
2925	1498	25	1	0	26	1	0.038461538461538464
2926	1526	22	0	0	22	0	0
2927	1497	21	1	0	22	1	0.045454545454545456
2928	1511	29	0	0	29	0	0
2929	1517	43	0	0	43	0	0
293	1508	19	1	0	20	1	0.05
2930	1521	29	1	0	30	1	0.03333333333333333
2931	1507	30	0	0	30	0	0
2932	1485	34	1	0	35	1	0.02857142857142857
2933	1495	39	2	0	41	2	0.04878048780487805
2934	1512	27	0	0	27	0	0
2935	1541	32	0	0	32	0	0
2936	1518	33	1	0	34	1	0.029411764705882353
2937	1530	28	2	0	30	2	0.06666666666666667
2938	1517	34	1	0	35	1	0.02857142857142857
2939	1482	23	2	0	25	2	0.08
294	1528	33	0	0	33	0	0
2940	1514	34	1	0	35	1	0.02857142857142857
2941	1483	28	1	0	29	1	0.034482758620689655
2942	1501	31	0	0	31	0	0
2943	1540	20	3	0	23	3	0.13043478260869565
2944	1500	38	0	0	38	0	0
2945	1496	38	1	0	39	1	0.02564102564102564
2946	1486	33	2	0	35	2	0.05714285714285714
2947	1496	28	1	0	29	1	0.034482758620689655
2948	1536	35	2	0	37	2	0.05405405405405406
2949	1501	33	0	0	33	0	0
295	1526	26	1	0	27	1	0.037037037037037035
2950	1531	29	0	0	29	0	0
2951	1498	27	0	0	27	0	0
2952	1535	31	1	0	32	1	0.03125
2953	1560	29	2	0	31	2	0.06451612903225806
2954	1483	46	1	0	47	1	0.02127659574468085
2955	1506	24	0	0	24	0	0
2956	1509	34	2	0	36	2	0.05555555555555555
2957	1535	31	0	0	31	0	0
2958	1542	31	0	0	31	0	0
2959	1502	25	1	0	26	1	0.038461538461538464
296	1517	25	0	0	25	0	0
2960	1492	35	0	0	35	0	0
2961	1527	26	0	0	26	0	0
2962	1525	37	4	0	41	4	0.0975609756097561
2963	1484	36	0	0	36	0	0
2964	1521	27	0	0	27	0	0
2965	1535	27	0	0	27	0	0
2966	1500	31	1	0	32	1	0.03125
2967	1497	29	1	0	30	1	0.03333333333333333
2968	1489	29	2	0	31	2	0.06451612903225806
2969	1514	33	0	0	33	0	0
297	1497	23	0	0	23	0	0
2970	1550	32	0	0	32	0	0
2971	1536	24	1	0	25	1	0.04
2972	1520	31	2	0	33	2	0.06060606060606061
2973	1497	34	1	0	35	1	0.02857142857142857
2974	1526	27	1	0	28	1	0.03571428571428571
2975	1492	16	0	0	16	0	0
2976	1498	24	1	0	25	1	0.04
2977	1528	30	3	0	33	3	0.09090909090909091
2978	1521	25	1	0	26	1	0.038461538461538464
2979	1514	37	1	0	38	1	0.02631578947368421
298	1524	29	0	0	29	0	0
2980	1527	40	0	0	40	0	0
2981	1486	27	1	0	28	1	0.03571428571428571
2982	1516	32	0	0	32	0	0
2983	1497	36	1	0	37	1	0.02702702702702703
2984	1539	32	1	0	33	1	0.030303030303030304
2985	1508	33	0	0	33	0	0
2986	1492	24	0	0	24	0	0
2987	1510	33	1	0	34	1	0.029411764705882353
2988	1539	33	0	0	33	0	0
2989	1483	29	1	0	30	1	0.03333333333333333
299	1490	32	1	0	33	1	0.030303030303030304
2990	1515	31	1	1	33	2	0.06060606060606061
2991	1494	26	2	0	28	2	0.07142857142857142
2992	1532	30	0	0	30	0	0
2993	1484	26	1	0	27	1	0.037037037037037035
2994	1501	28	3	0	31	3	0.0967741935483871
2995	1496	32	2	0	34	2	0.058823529411764705
2996	1518	30	1	0	31	1	0.03225806451612903
2997	1471	38	1	0	39	1	0.02564102564102564
2998	1483	36	1	0	37	1	0.02702702702702703
2999	1476	28	0	0	28	0	0
3	1499	29	1	0	30	1	0.03333333333333333
30	1485	31	0	0	31	0	0
300	1530	25	0	0	25	0	0
3000	1517	31	0	0	31	0	0
3001	1514	24	0	0	24	0	0
3002	1514	37	1	0	38	1	0.02631578947368421
3003	1504	35	1	0	36	1	0.027777777777777776
3004	1478	18	0	0	18	0	0
3005	1535	31	1	0	32	1	0.03125
3006	1527	27	0	0	27	0	0
3007	1533	20	1	0	21	1	0.047619047619047616
3008	1517	26	2	0	28	2	0.07142857142857142
3009	1513	29	1	0	30	1	0.03333333333333333
301	1550	37	0	0	37	0	0
3010	1463	27	0	0	27	0	0
3011	1503	21	1	0	22	1	0.045454545454545456
3012	1502	21	3	0	24	3	0.125
3013	1505	24	0	0	24	0	0
3014	1492	22	1	0	23	1	0.043478260869565216
3015	1512	29	1	0	30	1	0.03333333333333333
3016	1533	18	2	0	20	2	0.1
3017	1533	29	1	0	30	1	0.03333333333333333
3018	1515	33	0	0	33	0	0
3019	1502	24	0	0	24	0	0
302	1499	30	1	0	31	1	0.03225806451612903
3020	1515	29	0	0	29	0	0
3021	1517	28	2	0	30	2	0.06666666666666667
3022	1521	43	0	0	43	0	0
3023	1501	30	1	0	31	1	0.03225806451612903
3024	1529	34	1	0	35	1	0.02857142857142857
3025	1521	33	0	0	33	0	0
3026	1523	19	0	0	19	0	0
3027	1514	40	1	0	41	1	0.024390243902439025
3028	1494	24	1	0	25	1	0.04
3029	1531	31	0	0	31	0	0
303	1522	25	0	0	25	0	0
3030	1498	15	0	0	15	0	0
3031	1508	34	0	0	34	0	0
3032	1512	34	3	0	37	3	0.08108108108108109
3033	1492	34	1	0	35	1	0.02857142857142857
3034	1501	37	1	0	38	1	0.02631578947368421
3035	1499	37	0	0	37	0	0
3036	1496	27	1	0	28	1	0.03571428571428571
3037	1489	29	1	0	30	1	0.03333333333333333
3038	1522	24	0	0	24	0	0
3039	1503	31	1	0	32	1	0.03125
304	1501	37	0	0	37	0	0
3040	1515	30	1	0	31	1	0.03225806451612903
3041	1553	34	0	0	34	0	0
3042	1461	34	0	0	34	0	0
3043	1482	27	1	0	28	1	0.03571428571428571
3044	1531	27	1	0	28	1	0.03571428571428571
3045	1519	29	2	0	31	2	0.06451612903225806
3046	1522	25	1	0	26	1	0.038461538461538464
3047	1513	31	0	0	31	0	0
3048	1505	29	1	0	30	1	0.03333333333333333
3049	1525	37	2	0	39	2	0.05128205128205128
305	1524	30	0	0	30	0	0
3050	1485	28	1	0	29	1	0.034482758620689655
3051	1514	34	2	1	37	3	0.08108108108108109
3052	1513	34	1	0	35	1	0.02857142857142857
3053	1560	34	0	0	34	0	0
3054	1502	33	1	0	34	1	0.029411764705882353
3055	1527	36	2	0	38	2	0.05263157894736842
3056	1494	26	1	0	27	1	0.037037037037037035
3057	1518	37	1	0	38	1	0.02631578947368421
3058	1512	34	2	0	36	2	0.05555555555555555
3059	1505	25	0	0	25	0	0
306	1521	36	2	0	38	2	0.05263157894736842
3060	1523	26	2	0	28	2	0.07142857142857142
3061	1540	29	4	0	33	4	0.12121212121212122
3062	1515	24	1	0	25	1	0.04
3063	1488	24	1	1	26	2	0.07692307692307693
3064	1538	29	1	0	30	1	0.03333333333333333
3065	1518	23	0	0	23	0	0
3066	1515	30	0	0	30	0	0
3067	1517	26	1	0	27	1	0.037037037037037035
3068	1487	36	0	0	36	0	0
3069	1500	34	1	0	35	1	0.02857142857142857
307	1501	35	0	0	35	0	0
3070	1503	39	1	0	40	1	0.025
3071	1507	32	1	0	33	1	0.030303030303030304
3072	1522	34	0	0	34	0	0
3073	1538	28	0	0	28	0	0
3074	1536	34	0	0	34	0	0
3075	1506	24	2	0	26	2	0.07692307692307693
3076	1511	24	2	0	26	2	0.07692307692307693
3077	1556	38	1	0	39	1	0.02564102564102564
3078	1495	40	0	0	40	0	0
3079	1487	33	1	0	34	1	0.029411764705882353
308	1551	23	2	0	25	2	0.08
3080	1510	39	3	0	42	3	0.07142857142857142
3081	1529	29	1	0	30	1	0.03333333333333333
3082	1549	28	1	0	29	1	0.034482758620689655
3083	1513	31	2	0	33	2	0.06060606060606061
3084	1509	32	0	0	32	0	0
3085	1485	34	2	0	36	2	0.05555555555555555
3086	1555	20	1	0	21	1	0.047619047619047616
3087	1532	37	2	0	39	2	0.05128205128205128
3088	1501	25	2	0	27	2	0.07407407407407407
3089	1523	29	0	0	29	0	0
309	1521	36	2	0	38	2	0.05263157894736842
3090	1515	29	0	0	29	0	0
3091	1510	28	1	0	29	1	0.034482758620689655
3092	1540	23	2	0	25	2	0.08
3093	1521	33	1	0	34	1	0.029411764705882353
3094	1533	23	1	0	24	1	0.041666666666666664
3095	1505	31	4	0	35	4	0.11428571428571428
3096	1552	21	1	0	22	1	0.045454545454545456
3097	1513	39	1	0	40	1	0.025
3098	1517	17	3	0	20	3	0.15
3099	1504	30	0	0	30	0	0
31	1517	38	0	0	38	0	0
310	1482	34	1	0	35	1	0.02857142857142857
3100	1525	32	0	0	32	0	0
3101	1501	31	0	0	31	0	0
3102	1520	30	1	0	31	1	0.03225806451612903
3103	1532	32	0	0	32	0	0
3104	1487	37	0	0	37	0	0
3105	1485	39	4	0	43	4	0.09302325581395349
3106	1499	24	2	0	26	2	0.07692307692307693
3107	1530	32	2	0	34	2	0.058823529411764705
3108	1504	31	0	0	31	0	0
3109	1517	21	1	0	22	1	0.045454545454545456
311	1529	37	1	0	38	1	0.02631578947368421
3110	1491	37	0	0	37	0	0
3111	1510	35	1	0	36	1	0.027777777777777776
3112	1506	27	1	0	28	1	0.03571428571428571
3113	1538	27	1	0	28	1	0.03571428571428571
3114	1516	31	0	0	31	0	0
3115	1521	23	0	0	23	0	0
3116	1521	17	1	0	18	1	0.05555555555555555
3117	1505	26	1	0	27	1	0.037037037037037035
3118	1520	35	2	0	37	2	0.05405405405405406
3119	1517	37	1	0	38	1	0.02631578947368421
312	1521	32	1	0	33	1	0.030303030303030304
3120	1556	38	0	0	38	0	0
3121	1500	26	0	0	26	0	0
3122	1516	26	1	0	27	1	0.037037037037037035
3123	1504	30	1	0	31	1	0.03225806451612903
3124	1510	26	1	0	27	1	0.037037037037037035
3125	1492	38	1	0	39	1	0.02564102564102564
3126	1528	32	3	0	35	3	0.08571428571428572
3127	1509	31	0	0	31	0	0
3128	1533	35	1	0	36	1	0.027777777777777776
3129	1493	24	0	0	24	0	0
313	1492	34	1	0	35	1	0.02857142857142857
3130	1534	26	1	0	27	1	0.037037037037037035
3131	1510	25	0	0	25	0	0
3132	1529	34	1	0	35	1	0.02857142857142857
3133	1508	31	0	0	31	0	0
3134	1478	30	0	0	30	0	0
3135	1469	33	0	0	33	0	0
3136	1529	28	1	0	29	1	0.034482758620689655
3137	1529	30	3	0	33	3	0.09090909090909091
3138	1516	27	1	0	28	1	0.03571428571428571
3139	1513	30	0	0	30	0	0
314	1498	32	3	0	35	3	0.08571428571428572
3140	1466	17	0	0	17	0	0
3141	1514	29	0	0	29	0	0
3142	1478	31	0	0	31	0	0
3143	1487	29	1	0	30	1	0.03333333333333333
3144	1542	29	2	0	31	2	0.06451612903225806
3145	1498	32	1	0	33	1	0.030303030303030304
3146	1504	25	2	0	27	2	0.07407407407407407
3147	1505	33	0	0	33	0	0
3148	1496	30	0	0	30	0	0
3149	1492	27	0	0	27	0	0
315	1534	25	0	0	25	0	0
3150	1495	25	1	0	26	1	0.038461538461538464
3151	1514	40	0	0	40	0	0
3152	1499	21	0	0	21	0	0
3153	1516	32	1	0	33	1	0.030303030303030304
3154	1490	32	0	0	32	0	0
3155	1562	38	0	0	38	0	0
3156	1519	36	3	0	39	3	0.07692307692307693
3157	1499	30	1	0	31	1	0.03225806451612903
3158	1527	32	1	0	33	1	0.030303030303030304
3159	1509	34	0	0	34	0	0
316	1522	22	0	0	22	0	0
3160	1517	30	1	0	31	1	0.03225806451612903
3161	1529	26	1	0	27	1	0.037037037037037035
3162	1508	33	0	0	33	0	0
3163	1537	33	1	0	34	1	0.029411764705882353
3164	1526	26	0	0	26	0	0
3165	1500	26	2	1	29	3	0.10344827586206896
3166	1496	26	1	0	27	1	0.037037037037037035
3167	1484	33	1	0	34	1	0.029411764705882353
3168	1524	34	0	0	34	0	0
3169	1496	24	0	0	24	0	0
317	1504	36	1	0	37	1	0.02702702702702703
3170	1507	25	1	0	26	1	0.038461538461538464
3171	1544	22	1	0	23	1	0.043478260869565216
3172	1537	38	2	0	40	2	0.05
3173	1503	25	0	0	25	0	0
3174	1531	32	1	0	33	1	0.030303030303030304
3175	1543	39	2	0	41	2	0.04878048780487805
3176	1502	34	2	0	36	2	0.05555555555555555
3177	1519	31	2	0	33	2	0.06060606060606061
3178	1542	31	0	0	31	0	0
3179	1506	42	0	0	42	0	0
318	1516	25	0	0	25	0	0
3180	1523	34	0	0	34	0	0
3181	1536	34	1	0	35	1	0.02857142857142857
3182	1477	21	1	0	22	1	0.045454545454545456
3183	1487	30	0	0	30	0	0
3184	1517	31	0	0	31	0	0
3185	1518	28	1	0	29	1	0.034482758620689655
3186	1516	38	0	0	38	0	0
3187	1514	28	1	0	29	1	0.034482758620689655
3188	1509	28	2	0	30	2	0.06666666666666667
3189	1527	24	1	1	26	2	0.07692307692307693
319	1528	28	0	0	28	0	0
3190	1490	28	0	0	28	0	0
3191	1498	30	1	0	31	1	0.03225806451612903
3192	1507	36	2	0	38	2	0.05263157894736842
3193	1519	34	0	0	34	0	0
3194	1507	21	0	0	21	0	0
3195	1489	42	1	0	43	1	0.023255813953488372
3196	1542	29	2	0	31	2	0.06451612903225806
3197	1511	36	0	0	36	0	0
3198	1484	29	2	0	31	2	0.06451612903225806
3199	1500	23	0	0	23	0	0
32	1534	23	3	0	26	3	0.11538461538461539
320	1516	39	0	0	39	0	0
3200	1485	44	1	0	45	1	0.022222222222222223
3201	1535	30	0	0	30	0	0
3202	1500	32	0	0	32	0	0
3203	1500	27	2	0	29	2	0.06896551724137931
3204	1537	23	0	0	23	0	0
3205	1521	37	0	0	37	0	0
3206	1488	32	1	0	33	1	0.030303030303030304
3207	1539	27	2	0	29	2	0.06896551724137931
3208	1508	25	0	0	25	0	0
3209	1505	32	0	0	32	0	0
321	1479	34	1	0	35	1	0.02857142857142857
3210	1508	29	0	0	29	0	0
3211	1530	42	0	0	42	0	0
3212	1509	29	0	0	29	0	0
3213	1544	26	0	0	26	0	0
3214	1524	35	1	0	36	1	0.027777777777777776
3215	1498	36	0	0	36	0	0
3216	1553	27	0	0	27	0	0
3217	1490	34	0	0	34	0	0
3218	1493	31	1	0	32	1	0.03125
3219	1507	23	2	0	25	2	0.08
322	1517	32	2	0	34	2	0.058823529411764705
3220	1529	24	2	0	26	2	0.07692307692307693
3221	1525	32	0	0	32	0	0
3222	1505	37	0	0	37	0	0
3223	1513	24	0	0	24	0	0
3224	1498	30	0	0	30	0	0
3225	1498	28	1	0	29	1	0.034482758620689655
3226	1507	22	1	0	23	1	0.043478260869565216
3227	1481	25	1	0	26	1	0.038461538461538464
3228	1479	21	2	0	23	2	0.08695652173913043
3229	1479	38	0	1	39	1	0.02564102564102564
323	1515	38	1	0	39	1	0.02564102564102564
3230	1482	20	0	0	20	0	0
3231	1510	28	0	0	28	0	0
3232	1491	27	1	0	28	1	0.03571428571428571
3233	1529	36	0	0	36	0	0
3234	1522	30	2	0	32	2	0.0625
3235	1486	27	0	0	27	0	0
3236	1483	30	0	0	30	0	0
3237	1504	35	0	0	35	0	0
3238	1545	40	2	0	42	2	0.047619047619047616
3239	1474	20	3	0	23	3	0.13043478260869565
324	1457	36	1	0	37	1	0.02702702702702703
3240	1514	31	1	0	32	1	0.03125
3241	1511	30	1	0	31	1	0.03225806451612903
3242	1536	29	1	0	30	1	0.03333333333333333
3243	1501	38	1	0	39	1	0.02564102564102564
3244	1489	29	1	0	30	1	0.03333333333333333
3245	1539	34	2	0	36	2	0.05555555555555555
3246	1508	24	0	0	24	0	0
3247	1498	25	1	0	26	1	0.038461538461538464
3248	1535	31	1	0	32	1	0.03125
3249	1509	37	1	0	38	1	0.02631578947368421
325	1500	25	3	0	28	3	0.10714285714285714
3250	1475	30	0	0	30	0	0
3251	1531	40	0	0	40	0	0
3252	1470	32	0	0	32	0	0
3253	1506	24	0	0	24	0	0
3254	1520	42	1	0	43	1	0.023255813953488372
3255	1514	36	0	0	36	0	0
3256	1523	40	1	0	41	1	0.024390243902439025
3257	1524	27	0	0	27	0	0
3258	1533	25	1	0	26	1	0.038461538461538464
3259	1495	34	0	0	34	0	0
326	1481	23	1	0	24	1	0.041666666666666664
3260	1485	30	1	0	31	1	0.03225806451612903
3261	1499	28	1	0	29	1	0.034482758620689655
3262	1486	22	0	0	22	0	0
3263	1515	37	1	0	38	1	0.02631578947368421
3264	1509	21	0	0	21	0	0
3265	1528	24	1	0	25	1	0.04
3266	1480	22	0	0	22	0	0
3267	1475	33	5	0	38	5	0.13157894736842105
3268	1503	33	0	0	33	0	0
3269	1502	29	2	0	31	2	0.06451612903225806
327	1508	26	4	0	30	4	0.13333333333333333
3270	1548	30	1	0	31	1	0.03225806451612903
3271	1536	37	1	0	38	1	0.02631578947368421
3272	1520	27	1	0	28	1	0.03571428571428571
3273	1493	34	2	0	36	2	0.05555555555555555
3274	1478	33	0	0	33	0	0
3275	1477	32	1	0	33	1	0.030303030303030304
3276	1503	39	0	0	39	0	0
3277	1502	32	0	0	32	0	0
3278	1526	32	1	0	33	1	0.030303030303030304
3279	1557	30	0	0	30	0	0
328	1525	24	1	0	25	1	0.04
3280	1522	23	1	0	24	1	0.041666666666666664
3281	1515	36	0	0	36	0	0
3282	1499	32	0	0	32	0	0
3283	1487	31	1	0	32	1	0.03125
3284	1482	32	1	0	33	1	0.030303030303030304
3285	1526	32	0	0	32	0	0
3286	1497	29	1	0	30	1	0.03333333333333333
3287	1501	22	0	0	22	0	0
3288	1501	40	0	0	40	0	0
3289	1518	34	0	0	34	0	0
329	1517	23	0	0	23	0	0
3290	1508	35	0	0	35	0	0
3291	1521	25	1	0	26	1	0.038461538461538464
3292	1524	35	1	0	36	1	0.027777777777777776
3293	1492	28	1	0	29	1	0.034482758620689655
3294	1513	26	0	0	26	0	0
3295	1524	34	0	0	34	0	0
3296	1548	29	1	0	30	1	0.03333333333333333
3297	1479	25	0	0	25	0	0
3298	1498	27	0	0	27	0	0
3299	1490	33	0	0	33	0	0
33	1515	33	1	0	34	1	0.029411764705882353
330	1536	23	2	0	25	2	0.08
3300	1505	35	1	0	36	1	0.027777777777777776
3301	1513	30	1	0	31	1	0.03225806451612903
3302	1485	24	0	0	24	0	0
3303	1550	37	1	1	39	2	0.05128205128205128
3304	1500	27	0	0	27	0	0
3305	1522	24	0	0	24	0	0
3306	1538	25	1	0	26	1	0.038461538461538464
3307	1511	33	1	0	34	1	0.029411764705882353
3308	1539	28	2	0	30	2	0.06666666666666667
3309	1500	37	0	0	37	0	0
331	1525	39	0	0	39	0	0
3310	1502	34	2	0	36	2	0.05555555555555555
3311	1538	34	1	0	35	1	0.02857142857142857
3312	1522	30	1	0	31	1	0.03225806451612903
3313	1522	30	0	0	30	0	0
3314	1519	28	1	0	29	1	0.034482758620689655
3315	1484	45	1	0	46	1	0.021739130434782608
3316	1512	35	3	0	38	3	0.07894736842105263
3317	1519	25	0	0	25	0	0
3318	1485	36	1	0	37	1	0.02702702702702703
3319	1553	35	1	0	36	1	0.027777777777777776
332	1497	36	0	0	36	0	0
3320	1528	41	0	0	41	0	0
3321	1518	32	2	0	34	2	0.058823529411764705
3322	1513	36	0	0	36	0	0
3323	1503	20	1	0	21	1	0.047619047619047616
3324	1522	25	3	0	28	3	0.10714285714285714
3325	1487	35	0	0	35	0	0
3326	1486	39	1	0	40	1	0.025
3327	1498	27	0	0	27	0	0
3328	1479	27	2	1	30	3	0.1
3329	1493	26	1	0	27	1	0.037037037037037035
333	1512	34	1	0	35	1	0.02857142857142857
3330	1513	27	1	0	28	1	0.03571428571428571
3331	1536	38	1	0	39	1	0.02564102564102564
3332	1508	29	0	0	29	0	0
3333	1520	30	0	0	30	0	0
3334	1474	30	1	0	31	1	0.03225806451612903
3335	1517	27	1	0	28	1	0.03571428571428571
3336	1530	25	0	0	25	0	0
3337	1489	40	1	0	41	1	0.024390243902439025
3338	1537	41	0	0	41	0	0
3339	1500	45	2	0	47	2	0.0425531914893617
334	1529	36	1	0	37	1	0.02702702702702703
3340	1518	32	1	0	33	1	0.030303030303030304
3341	1555	38	2	0	40	2	0.05
3342	1525	36	1	0	37	1	0.02702702702702703
3343	1538	17	0	0	17	0	0
3344	1515	32	2	0	34	2	0.058823529411764705
3345	1511	22	1	0	23	1	0.043478260869565216
3346	1546	35	0	0	35	0	0
3347	1526	31	1	0	32	1	0.03125
3348	1502	37	2	0	39	2	0.05128205128205128
3349	1524	31	1	0	32	1	0.03125
335	1513	25	1	0	26	1	0.038461538461538464
3350	1539	23	1	0	24	1	0.041666666666666664
3351	1514	43	1	0	44	1	0.022727272727272728
3352	1518	26	2	0	28	2	0.07142857142857142
3353	1532	30	0	0	30	0	0
3354	1534	21	0	0	21	0	0
3355	1537	32	2	0	34	2	0.058823529411764705
3356	1523	25	1	0	26	1	0.038461538461538464
3357	1515	35	0	0	35	0	0
3358	1481	41	0	0	41	0	0
3359	1496	33	0	0	33	0	0
336	1557	22	0	0	22	0	0
3360	1496	34	0	0	34	0	0
3361	1519	25	0	0	25	0	0
3362	1476	28	1	0	29	1	0.034482758620689655
3363	1518	32	1	0	33	1	0.030303030303030304
3364	1508	35	0	0	35	0	0
3365	1480	35	0	0	35	0	0
3366	1502	29	1	0	30	1	0.03333333333333333
3367	1505	34	0	0	34	0	0
3368	1508	33	2	0	35	2	0.05714285714285714
3369	1514	32	0	0	32	0	0
337	1532	36	1	0	37	1	0.02702702702702703
3370	1512	29	1	0	30	1	0.03333333333333333
3371	1513	33	0	0	33	0	0
3372	1514	28	0	0	28	0	0
3373	1496	29	1	0	30	1	0.03333333333333333
3374	1538	23	2	0	25	2	0.08
3375	1493	28	1	0	29	1	0.034482758620689655
3376	1513	25	2	0	27	2	0.07407407407407407
3377	1522	38	3	0	41	3	0.07317073170731707
3378	1517	32	0	0	32	0	0
3379	1506	44	2	0	46	2	0.043478260869565216
338	1508	21	0	0	21	0	0
3380	1486	34	0	0	34	0	0
3381	1459	35	0	0	35	0	0
3382	1515	41	0	0	41	0	0
3383	1510	20	1	0	21	1	0.047619047619047616
3384	1505	28	0	0	28	0	0
3385	1500	32	0	0	32	0	0
3386	1535	21	2	0	23	2	0.08695652173913043
3387	1499	33	0	0	33	0	0
3388	1522	35	2	0	37	2	0.05405405405405406
3389	1478	32	0	0	32	0	0
339	1545	31	2	0	33	2	0.06060606060606061
3390	1510	25	1	0	26	1	0.038461538461538464
3391	1527	29	0	0	29	0	0
3392	1493	31	1	0	32	1	0.03125
3393	1530	32	0	0	32	0	0
3394	1511	27	1	0	28	1	0.03571428571428571
3395	1475	37	0	0	37	0	0
3396	1544	23	0	0	23	0	0
3397	1490	31	0	0	31	0	0
3398	1475	34	0	0	34	0	0
3399	1496	25	0	0	25	0	0
34	1508	27	1	0	28	1	0.03571428571428571
340	1522	35	1	0	36	1	0.027777777777777776
3400	1519	36	1	0	37	1	0.02702702702702703
3401	1511	24	2	0	26	2	0.07692307692307693
3402	1491	40	0	0	40	0	0
3403	1537	23	1	0	24	1	0.041666666666666664
3404	1502	27	1	0	28	1	0.03571428571428571
3405	1498	33	1	0	34	1	0.029411764705882353
3406	1528	22	0	0	22	0	0
3407	1538	24	0	0	24	0	0
3408	1520	20	2	0	22	2	0.09090909090909091
3409	1496	29	1	0	30	1	0.03333333333333333
341	1501	44	0	0	44	0	0
3410	1509	31	0	0	31	0	0
3411	1518	31	1	0	32	1	0.03125
3412	1528	24	3	0	27	3	0.1111111111111111
3413	1509	17	0	0	17	0	0
3414	1481	28	0	0	28	0	0
3415	1488	35	0	0	35	0	0
3416	1481	30	1	0	31	1	0.03225806451612903
3417	1520	28	0	0	28	0	0
3418	1510	31	0	0	31	0	0
3419	1528	28	1	0	29	1	0.034482758620689655
342	1508	29	0	0	29	0	0
3420	1490	35	1	0	36	1	0.027777777777777776
3421	1532	47	1	0	48	1	0.020833333333333332
3422	1504	31	0	1	32	1	0.03125
3423	1521	39	1	0	40	1	0.025
3424	1509	30	2	0	32	2	0.0625
3425	1519	30	1	0	31	1	0.03225806451612903
3426	1506	32	2	0	34	2	0.058823529411764705
3427	1510	29	1	0	30	1	0.03333333333333333
3428	1514	22	2	0	24	2	0.08333333333333333
3429	1517	32	0	0	32	0	0
343	1503	38	1	0	39	1	0.02564102564102564
3430	1477	20	0	0	20	0	0
3431	1486	25	0	0	25	0	0
3432	1507	39	0	1	40	1	0.025
3433	1501	29	0	0	29	0	0
3434	1503	33	2	0	35	2	0.05714285714285714
3435	1487	25	1	0	26	1	0.038461538461538464
3436	1488	33	0	0	33	0	0
3437	1525	36	0	0	36	0	0
3438	1520	37	0	0	37	0	0
3439	1521	25	1	0	26	1	0.038461538461538464
344	1499	34	0	0	34	0	0
3440	1469	35	0	0	35	0	0
3441	1513	24	0	0	24	0	0
3442	1505	18	1	0	19	1	0.05263157894736842
3443	1482	30	0	0	30	0	0
3444	1480	19	0	0	19	0	0
3445	1546	43	0	0	43	0	0
3446	1506	21	0	0	21	0	0
3447	1510	24	2	0	26	2	0.07692307692307693
3448	1486	27	1	0	28	1	0.03571428571428571
3449	1523	34	0	0	34	0	0
345	1519	25	1	0	26	1	0.038461538461538464
3450	1512	36	1	0	37	1	0.02702702702702703
3451	1480	30	0	0	30	0	0
3452	1527	37	0	0	37	0	0
3453	1503	23	1	0	24	1	0.041666666666666664
3454	1526	29	1	0	30	1	0.03333333333333333
3455	1512	27	1	0	28	1	0.03571428571428571
3456	1486	25	1	0	26	1	0.038461538461538464
3457	1542	28	2	0	30	2	0.06666666666666667
3458	1524	26	3	0	29	3	0.10344827586206896
3459	1526	28	1	0	29	1	0.034482758620689655
346	1498	32	0	0	32	0	0
3460	1508	35	1	0	36	1	0.027777777777777776
3461	1522	32	2	0	34	2	0.058823529411764705
3462	1471	32	0	0	32	0	0
3463	1490	26	1	0	27	1	0.037037037037037035
3464	1497	38	1	0	39	1	0.02564102564102564
3465	1466	24	1	0	25	1	0.04
3466	1505	25	0	0	25	0	0
3467	1524	34	0	0	34	0	0
3468	1483	33	1	0	34	1	0.029411764705882353
3469	1494	38	1	0	39	1	0.02564102564102564
347	1510	29	2	0	31	2	0.06451612903225806
3470	1524	30	0	0	30	0	0
3471	1504	30	1	0	31	1	0.03225806451612903
3472	1488	34	0	0	34	0	0
3473	1479	31	1	0	32	1	0.03125
3474	1494	27	0	0	27	0	0
3475	1472	27	1	0	28	1	0.03571428571428571
3476	1525	25	0	0	25	0	0
3477	1536	24	3	0	27	3	0.1111111111111111
3478	1509	31	1	0	32	1	0.03125
3479	1531	40	0	0	40	0	0
348	1482	32	2	0	34	2	0.058823529411764705
3480	1530	31	0	0	31	0	0
3481	1514	33	1	0	34	1	0.029411764705882353
3482	1510	40	0	0	40	0	0
3483	1511	22	0	0	22	0	0
3484	1492	20	0	0	20	0	0
3485	1504	33	0	0	33	0	0
3486	1525	24	0	0	24	0	0
3487	1513	38	1	0	39	1	0.02564102564102564
3488	1544	37	2	0	39	2	0.05128205128205128
3489	1509	32	1	0	33	1	0.030303030303030304
349	1525	34	1	0	35	1	0.02857142857142857
3490	1514	25	0	0	25	0	0
3491	1493	39	1	0	40	1	0.025
3492	1516	31	1	0	32	1	0.03125
3493	1525	31	2	0	33	2	0.06060606060606061
3494	1522	28	1	0	29	1	0.034482758620689655
3495	1499	32	1	0	33	1	0.030303030303030304
3496	1506	35	0	0	35	0	0
3497	1504	24	2	0	26	2	0.07692307692307693
3498	1493	31	1	0	32	1	0.03125
3499	1495	33	1	0	34	1	0.029411764705882353
35	1520	27	3	0	30	3	0.1
350	1500	30	0	0	30	0	0
3500	1523	30	2	0	32	2	0.0625
3501	1526	38	2	0	40	2	0.05
3502	1513	36	0	0	36	0	0
3503	1555	36	2	0	38	2	0.05263157894736842
3504	1521	25	0	0	25	0	0
3505	1514	25	0	0	25	0	0
3506	1503	19	1	0	20	1	0.05
3507	1528	30	1	0	31	1	0.03225806451612903
3508	1495	36	1	1	38	2	0.05263157894736842
3509	1484	22	3	0	25	3	0.12
351	1519	23	1	0	24	1	0.041666666666666664
3510	1474	26	0	0	26	0	0
3511	1503	45	1	0	46	1	0.021739130434782608
3512	1515	28	0	0	28	0	0
3513	1511	36	1	0	37	1	0.02702702702702703
3514	1498	23	2	0	25	2	0.08
3515	1494	37	1	0	38	1	0.02631578947368421
3516	1508	26	2	0	28	2	0.07142857142857142
3517	1455	35	2	0	37	2	0.05405405405405406
3518	1498	38	1	0	39	1	0.02564102564102564
3519	1518	21	3	1	25	4	0.16
352	1486	30	0	0	30	0	0
3520	1474	20	0	0	20	0	0
3521	1513	27	0	0	27	0	0
3522	1505	36	1	0	37	1	0.02702702702702703
3523	1527	37	1	0	38	1	0.02631578947368421
3524	1500	27	0	0	27	0	0
3525	1518	23	0	0	23	0	0
3526	1512	22	0	0	22	0	0
3527	1519	29	1	0	30	1	0.03333333333333333
3528	1494	31	1	0	32	1	0.03125
3529	1512	19	0	0	19	0	0
353	1537	30	1	0	31	1	0.03225806451612903
3530	1502	27	4	0	31	4	0.12903225806451613
3531	1529	29	0	0	29	0	0
3532	1510	30	2	0	32	2	0.0625
3533	1486	33	4	0	37	4	0.10810810810810811
3534	1524	27	0	0	27	0	0
3535	1497	46	0	0	46	0	0
3536	1526	26	0	0	26	0	0
3537	1461	29	0	0	29	0	0
3538	1503	33	1	0	34	1	0.029411764705882353
3539	1486	53	1	0	54	1	0.018518518518518517
354	1490	25	1	0	26	1	0.038461538461538464
3540	1522	43	0	0	43	0	0
3541	1503	25	1	0	26	1	0.038461538461538464
3542	1513	32	1	0	33	1	0.030303030303030304
3543	1515	24	0	0	24	0	0
3544	1508	25	1	0	26	1	0.038461538461538464
3545	1512	28	1	0	29	1	0.034482758620689655
3546	1538	27	0	0	27	0	0
3547	1486	30	0	0	30	0	0
3548	1495	28	4	0	32	4	0.125
3549	1528	27	1	0	28	1	0.03571428571428571
355	1507	34	1	0	35	1	0.02857142857142857
3550	1514	33	0	0	33	0	0
3551	1511	29	2	0	31	2	0.06451612903225806
3552	1508	28	0	0	28	0	0
3553	1514	28	2	0	30	2	0.06666666666666667
3554	1498	31	2	0	33	2	0.06060606060606061
3555	1512	31	1	0	32	1	0.03125
3556	1501	25	0	0	25	0	0
3557	1532	24	1	0	25	1	0.04
3558	1528	35	1	0	36	1	0.027777777777777776
3559	1510	35	1	0	36	1	0.027777777777777776
356	1514	35	0	0	35	0	0
3560	1512	36	1	0	37	1	0.02702702702702703
3561	1525	30	1	0	31	1	0.03225806451612903
3562	1503	35	1	0	36	1	0.027777777777777776
3563	1494	31	1	0	32	1	0.03125
3564	1508	28	1	0	29	1	0.034482758620689655
3565	1504	30	0	0	30	0	0
3566	1505	20	0	0	20	0	0
3567	1555	32	1	0	33	1	0.030303030303030304
3568	1475	26	1	0	27	1	0.037037037037037035
3569	1528	38	0	0	38	0	0
357	1518	23	0	0	23	0	0
3570	1460	31	0	0	31	0	0
3571	1488	32	0	0	32	0	0
3572	1499	34	0	0	34	0	0
3573	1535	31	1	0	32	1	0.03125
3574	1515	24	0	0	24	0	0
3575	1492	29	0	0	29	0	0
3576	1510	31	2	0	33	2	0.06060606060606061
3577	1492	25	1	0	26	1	0.038461538461538464
3578	1527	38	1	0	39	1	0.02564102564102564
3579	1538	35	0	0	35	0	0
358	1520	35	2	0	37	2	0.05405405405405406
3580	1507	27	0	0	27	0	0
3581	1523	34	1	0	35	1	0.02857142857142857
3582	1498	31	3	0	34	3	0.08823529411764706
3583	1495	23	1	0	24	1	0.041666666666666664
3584	1521	31	0	0	31	0	0
3585	1532	28	1	0	29	1	0.034482758620689655
3586	1511	25	0	0	25	0	0
3587	1489	25	1	0	26	1	0.038461538461538464
3588	1472	36	1	0	37	1	0.02702702702702703
3589	1558	29	1	0	30	1	0.03333333333333333
359	1501	23	1	0	24	1	0.041666666666666664
3590	1530	35	1	0	36	1	0.027777777777777776
3591	1491	32	1	0	33	1	0.030303030303030304
3592	1525	28	1	0	29	1	0.034482758620689655
3593	1514	28	0	0	28	0	0
3594	1549	38	0	0	38	0	0
3595	1524	35	0	0	35	0	0
3596	1548	26	0	0	26	0	0
3597	1482	33	0	0	33	0	0
3598	1485	21	2	0	23	2	0.08695652173913043
3599	1520	27	2	0	29	2	0.06896551724137931
36	1536	27	1	0	28	1	0.03571428571428571
360	1495	33	0	0	33	0	0
3600	1522	23	2	0	25	2	0.08
3601	1515	32	0	0	32	0	0
3602	1503	28	1	0	29	1	0.034482758620689655
3603	1509	31	0	0	31	0	0
3604	1514	32	2	0	34	2	0.058823529411764705
3605	1478	39	2	0	41	2	0.04878048780487805
3606	1492	33	1	0	34	1	0.029411764705882353
3607	1521	28	0	0	28	0	0
3608	1501	43	2	0	45	2	0.044444444444444446
3609	1511	38	1	0	39	1	0.02564102564102564
361	1481	35	0	0	35	0	0
3610	1504	27	1	0	28	1	0.03571428571428571
3611	1494	29	0	0	29	0	0
3612	1490	30	0	0	30	0	0
3613	1516	27	1	0	28	1	0.03571428571428571
3614	1494	26	1	0	27	1	0.037037037037037035
3615	1515	36	0	0	36	0	0
3616	1523	30	1	0	31	1	0.03225806451612903
3617	1531	29	2	0	31	2	0.06451612903225806
3618	1509	37	2	0	39	2	0.05128205128205128
3619	1501	31	0	0	31	0	0
362	1489	30	0	0	30	0	0
3620	1510	31	0	0	31	0	0
3621	1489	35	0	0	35	0	0
3622	1496	24	2	0	26	2	0.07692307692307693
3623	1488	20	1	0	21	1	0.047619047619047616
3624	1496	31	0	0	31	0	0
3625	1502	29	1	0	30	1	0.03333333333333333
3626	1492	31	0	0	31	0	0
3627	1494	24	0	0	24	0	0
3628	1509	29	0	0	29	0	0
3629	1498	30	0	0	30	0	0
363	1515	27	0	0	27	0	0
3630	1498	38	0	0	38	0	0
3631	1471	31	1	0	32	1	0.03125
3632	1494	31	1	0	32	1	0.03125
3633	1519	29	1	0	30	1	0.03333333333333333
3634	1481	35	0	0	35	0	0
3635	1491	33	3	0	36	3	0.08333333333333333
3636	1480	32	0	0	32	0	0
3637	1503	31	2	0	33	2	0.06060606060606061
3638	1505	35	0	0	35	0	0
3639	1532	25	1	0	26	1	0.038461538461538464
364	1489	40	0	0	40	0	0
3640	1496	28	1	0	29	1	0.034482758620689655
3641	1498	35	0	0	35	0	0
3642	1492	29	1	0	30	1	0.03333333333333333
3643	1510	26	1	0	27	1	0.037037037037037035
3644	1559	15	0	0	15	0	0
3645	1498	35	1	0	36	1	0.027777777777777776
3646	1535	32	2	0	34	2	0.058823529411764705
3647	1516	35	1	0	36	1	0.027777777777777776
3648	1515	31	0	0	31	0	0
3649	1533	22	0	0	22	0	0
365	1519	28	0	0	28	0	0
3650	1500	33	0	0	33	0	0
3651	1501	32	2	0	34	2	0.058823529411764705
3652	1529	34	2	0	36	2	0.05555555555555555
3653	1493	35	1	0	36	1	0.027777777777777776
3654	1508	38	0	0	38	0	0
3655	1527	28	2	0	30	2	0.06666666666666667
3656	1532	36	1	0	37	1	0.02702702702702703
3657	1485	22	2	0	24	2	0.08333333333333333
3658	1508	25	0	0	25	0	0
3659	1500	26	1	0	27	1	0.037037037037037035
366	1507	34	0	0	34	0	0
3660	1495	36	1	0	37	1	0.02702702702702703
3661	1496	26	4	0	30	4	0.13333333333333333
3662	1507	35	0	0	35	0	0
3663	1506	38	1	0	39	1	0.02564102564102564
3664	1496	32	1	0	33	1	0.030303030303030304
3665	1527	41	1	0	42	1	0.023809523809523808
3666	1504	38	0	0	38	0	0
3667	1516	32	1	0	33	1	0.030303030303030304
3668	1509	32	2	0	34	2	0.058823529411764705
3669	1520	26	0	0	26	0	0
367	1525	23	0	0	23	0	0
3670	1479	21	1	0	22	1	0.045454545454545456
3671	1546	33	2	0	35	2	0.05714285714285714
3672	1536	28	0	0	28	0	0
3673	1531	24	0	0	24	0	0
3674	1515	22	1	0	23	1	0.043478260869565216
3675	1528	29	1	0	30	1	0.03333333333333333
3676	1497	30	0	0	30	0	0
3677	1510	28	0	0	28	0	0
3678	1516	34	0	0	34	0	0
3679	1517	34	0	0	34	0	0
368	1537	30	1	0	31	1	0.03225806451612903
3680	1505	27	0	0	27	0	0
3681	1500	38	1	0	39	1	0.02564102564102564
3682	1480	39	1	0	40	1	0.025
3683	1470	28	1	0	29	1	0.034482758620689655
3684	1500	39	3	0	42	3	0.07142857142857142
3685	1521	29	1	0	30	1	0.03333333333333333
3686	1501	33	4	0	37	4	0.10810810810810811
3687	1528	41	2	0	43	2	0.046511627906976744
3688	1485	40	1	0	41	1	0.024390243902439025
3689	1493	39	1	0	40	1	0.025
369	1480	24	1	0	25	1	0.04
3690	1501	33	1	0	34	1	0.029411764705882353
3691	1498	39	0	0	39	0	0
3692	1489	29	1	0	30	1	0.03333333333333333
3693	1524	31	1	0	32	1	0.03125
3694	1525	21	0	0	21	0	0
3695	1548	32	1	0	33	1	0.030303030303030304
3696	1547	27	1	0	28	1	0.03571428571428571
3697	1523	31	1	0	32	1	0.03125
3698	1505	29	0	0	29	0	0
3699	1546	31	0	0	31	0	0
37	1492	34	0	0	34	0	0
370	1518	30	0	0	30	0	0
3700	1485	27	0	0	27	0	0
3701	1513	33	1	0	34	1	0.029411764705882353
3702	1509	22	0	0	22	0	0
3703	1538	39	0	0	39	0	0
3704	1526	36	0	0	36	0	0
3705	1518	23	1	0	24	1	0.041666666666666664
3706	1529	34	0	0	34	0	0
3707	1489	26	2	0	28	2	0.07142857142857142
3708	1502	33	1	0	34	1	0.029411764705882353
3709	1510	31	2	0	33	2	0.06060606060606061
371	1478	30	1	0	31	1	0.03225806451612903
3710	1494	22	1	0	23	1	0.043478260869565216
3711	1498	27	2	0	29	2	0.06896551724137931
3712	1524	35	2	0	37	2	0.05405405405405406
3713	1500	31	0	0	31	0	0
3714	1544	27	1	0	28	1	0.03571428571428571
3715	1495	27	0	0	27	0	0
3716	1531	30	0	0	30	0	0
3717	1525	29	0	0	29	0	0
3718	1524	32	1	0	33	1	0.030303030303030304
3719	1521	26	0	0	26	0	0
372	1501	38	0	0	38	0	0
3720	1516	35	2	0	37	2	0.05405405405405406
3721	1501	27	1	0	28	1	0.03571428571428571
3722	1501	29	2	0	31	2	0.06451612903225806
3723	1502	45	1	0	46	1	0.021739130434782608
3724	1545	22	0	0	22	0	0
3725	1494	48	1	0	49	1	0.02040816326530612
3726	1508	25	2	0	27	2	0.07407407407407407
3727	1479	34	2	0	36	2	0.05555555555555555
3728	1530	26	2	0	28	2	0.07142857142857142
3729	1513	34	1	0	35	1	0.02857142857142857
373	1514	26	0	0	26	0	0
3730	1518	36	2	0	38	2	0.05263157894736842
3731	1530	42	0	0	42	0	0
3732	1504	27	1	0	28	1	0.03571428571428571
3733	1514	29	3	1	33	4	0.12121212121212122
3734	1526	28	0	0	28	0	0
3735	1536	35	1	0	36	1	0.027777777777777776
3736	1485	29	1	0	30	1	0.03333333333333333
3737	1512	20	1	0	21	1	0.047619047619047616
3738	1499	34	1	0	35	1	0.02857142857142857
3739	1525	27	0	0	27	0	0
374	1496	34	3	0	37	3	0.08108108108108109
3740	1504	36	0	0	36	0	0
3741	1503	39	2	0	41	2	0.04878048780487805
3742	1526	30	1	0	31	1	0.03225806451612903
3743	1516	29	0	0	29	0	0
3744	1508	37	0	0	37	0	0
3745	1513	35	1	0	36	1	0.027777777777777776
3746	1545	27	0	0	27	0	0
3747	1511	30	2	0	32	2	0.0625
3748	1482	33	0	0	33	0	0
3749	1513	31	0	0	31	0	0
375	1503	28	2	0	30	2	0.06666666666666667
3750	1512	40	1	0	41	1	0.024390243902439025
3751	1526	22	0	0	22	0	0
3752	1513	34	1	0	35	1	0.02857142857142857
3753	1512	26	2	0	28	2	0.07142857142857142
3754	1508	20	1	0	21	1	0.047619047619047616
3755	1460	33	0	0	33	0	0
3756	1495	17	0	0	17	0	0
3757	1518	33	1	0	34	1	0.029411764705882353
3758	1537	31	1	0	32	1	0.03125
3759	1509	38	2	0	40	2	0.05
376	1508	34	2	0	36	2	0.05555555555555555
3760	1540	23	2	0	25	2	0.08
3761	1491	32	0	0	32	0	0
3762	1512	27	0	0	27	0	0
3763	1524	15	0	0	15	0	0
3764	1491	40	0	0	40	0	0
3765	1485	24	1	0	25	1	0.04
3766	1492	27	1	0	28	1	0.03571428571428571
3767	1523	31	3	0	34	3	0.08823529411764706
3768	1528	31	1	0	32	1	0.03125
3769	1530	28	1	0	29	1	0.034482758620689655
377	1521	22	0	0	22	0	0
3770	1487	26	2	0	28	2	0.07142857142857142
3771	1521	26	0	0	26	0	0
3772	1506	35	0	0	35	0	0
3773	1527	27	1	0	28	1	0.03571428571428571
3774	1511	35	1	0	36	1	0.027777777777777776
3775	1506	24	0	0	24	0	0
3776	1475	24	1	0	25	1	0.04
3777	1503	31	0	0	31	0	0
3778	1563	34	0	0	34	0	0
3779	1520	18	0	0	18	0	0
378	1488	32	1	0	33	1	0.030303030303030304
3780	1531	29	2	0	31	2	0.06451612903225806
3781	1523	27	3	0	30	3	0.1
3782	1509	26	1	0	27	1	0.037037037037037035
3783	1497	30	0	0	30	0	0
3784	1511	28	2	0	30	2	0.06666666666666667
3785	1505	29	1	0	30	1	0.03333333333333333
3786	1490	23	0	0	23	0	0
3787	1527	33	1	0	34	1	0.029411764705882353
3788	1493	36	2	0	38	2	0.05263157894736842
3789	1493	23	1	0	24	1	0.041666666666666664
379	1504	29	1	0	30	1	0.03333333333333333
3790	1501	33	2	0	35	2	0.05714285714285714
3791	1489	34	2	0	36	2	0.05555555555555555
3792	1500	29	0	0	29	0	0
3793	1486	27	0	0	27	0	0
3794	1528	30	3	0	33	3	0.09090909090909091
3795	1502	23	1	0	24	1	0.041666666666666664
3796	1530	32	0	0	32	0	0
3797	1506	32	0	0	32	0	0
3798	1505	22	2	0	24	2	0.08333333333333333
3799	1505	33	1	0	34	1	0.029411764705882353
38	1514	22	1	0	23	1	0.043478260869565216
380	1513	35	0	0	35	0	0
3800	1529	27	2	0	29	2	0.06896551724137931
3801	1531	30	0	0	30	0	0
3802	1491	29	0	0	29	0	0
3803	1521	33	0	0	33	0	0
3804	1512	24	0	0	24	0	0
3805	1475	31	0	0	31	0	0
3806	1522	31	1	0	32	1	0.03125
3807	1532	33	2	0	35	2	0.05714285714285714
3808	1483	41	0	0	41	0	0
3809	1478	27	0	0	27	0	0
381	1499	38	1	0	39	1	0.02564102564102564
3810	1499	38	1	0	39	1	0.02564102564102564
3811	1536	33	0	0	33	0	0
3812	1547	30	0	0	30	0	0
3813	1517	27	2	0	29	2	0.06896551724137931
3814	1530	26	2	0	28	2	0.07142857142857142
3815	1499	27	1	0	28	1	0.03571428571428571
3816	1507	29	1	0	30	1	0.03333333333333333
3817	1525	27	1	0	28	1	0.03571428571428571
3818	1508	26	1	0	27	1	0.037037037037037035
3819	1503	34	2	0	36	2	0.05555555555555555
382	1527	28	2	0	30	2	0.06666666666666667
3820	1492	32	0	0	32	0	0
3821	1502	24	3	0	27	3	0.1111111111111111
3822	1495	27	0	0	27	0	0
3823	1499	23	0	0	23	0	0
3824	1540	35	1	0	36	1	0.027777777777777776
3825	1511	37	1	0	38	1	0.02631578947368421
3826	1505	29	2	0	31	2	0.06451612903225806
3827	1526	36	2	0	38	2	0.05263157894736842
3828	1502	20	2	0	22	2	0.09090909090909091
3829	1520	28	2	0	30	2	0.06666666666666667
383	1501	33	1	0	34	1	0.029411764705882353
3830	1500	28	1	0	29	1	0.034482758620689655
3831	1513	35	1	0	36	1	0.027777777777777776
3832	1500	33	0	0	33	0	0
3833	1508	35	0	0	35	0	0
3834	1537	35	1	0	36	1	0.027777777777777776
3835	1513	37	2	0	39	2	0.05128205128205128
3836	1535	23	0	0	23	0	0
3837	1514	25	0	0	25	0	0
3838	1519	26	0	0	26	0	0
3839	1514	39	2	0	41	2	0.04878048780487805
384	1506	33	2	0	35	2	0.05714285714285714
3840	1495	30	1	0	31	1	0.03225806451612903
3841	1489	46	1	0	47	1	0.02127659574468085
3842	1465	42	0	0	42	0	0
3843	1496	40	1	0	41	1	0.024390243902439025
3844	1529	32	0	0	32	0	0
3845	1516	29	0	0	29	0	0
3846	1497	29	2	0	31	2	0.06451612903225806
3847	1531	42	1	0	43	1	0.023255813953488372
3848	1509	42	0	0	42	0	0
3849	1482	31	0	0	31	0	0
385	1519	28	2	0	30	2	0.06666666666666667
3850	1478	33	3	0	36	3	0.08333333333333333
3851	1504	28	1	0	29	1	0.034482758620689655
3852	1498	30	2	0	32	2	0.0625
3853	1524	30	1	0	31	1	0.03225806451612903
3854	1517	30	0	0	30	0	0
3855	1557	31	0	0	31	0	0
3856	1520	23	1	0	24	1	0.041666666666666664
3857	1521	21	1	0	22	1	0.045454545454545456
3858	1477	26	0	0	26	0	0
3859	1479	30	2	0	32	2	0.0625
386	1507	27	0	0	27	0	0
3860	1513	27	0	0	27	0	0
3861	1511	29	1	0	30	1	0.03333333333333333
3862	1515	30	0	0	30	0	0
3863	1504	33	1	0	34	1	0.029411764705882353
3864	1514	40	0	0	40	0	0
3865	1529	31	0	0	31	0	0
3866	1475	35	2	0	37	2	0.05405405405405406
3867	1526	22	2	0	24	2	0.08333333333333333
3868	1535	30	2	0	32	2	0.0625
3869	1474	28	2	0	30	2	0.06666666666666667
387	1507	35	1	0	36	1	0.027777777777777776
3870	1469	26	1	0	27	1	0.037037037037037035
3871	1523	33	2	0	35	2	0.05714285714285714
3872	1511	38	1	0	39	1	0.02564102564102564
3873	1504	33	2	0	35	2	0.05714285714285714
3874	1505	44	0	0	44	0	0
3875	1467	33	2	0	35	2	0.05714285714285714
3876	1541	29	0	0	29	0	0
3877	1496	30	0	0	30	0	0
3878	1526	15	0	0	15	0	0
3879	1501	33	0	0	33	0	0
388	1522	34	2	0	36	2	0.05555555555555555
3880	1512	30	1	0	31	1	0.03225806451612903
3881	1542	31	1	0	32	1	0.03125
3882	1508	31	1	0	32	1	0.03125
3883	1541	30	0	0	30	0	0
3884	1519	30	2	0	32	2	0.0625
3885	1493	34	3	0	37	3	0.08108108108108109
3886	1498	23	2	0	25	2	0.08
3887	1505	31	0	0	31	0	0
3888	1519	40	1	0	41	1	0.024390243902439025
3889	1492	28	0	0	28	0	0
389	1490	25	0	0	25	0	0
3890	1550	27	1	0	28	1	0.03571428571428571
3891	1513	34	1	0	35	1	0.02857142857142857
3892	1498	30	1	0	31	1	0.03225806451612903
3893	1511	27	0	0	27	0	0
3894	1515	39	0	0	39	0	0
3895	1501	29	0	0	29	0	0
3896	1511	22	2	0	24	2	0.08333333333333333
3897	1478	34	2	0	36	2	0.05555555555555555
3898	1531	31	2	0	33	2	0.06060606060606061
3899	1503	28	0	0	28	0	0
39	1514	27	1	0	28	1	0.03571428571428571
390	1520	22	0	0	22	0	0
3900	1536	35	0	0	35	0	0
3901	1501	20	0	0	20	0	0
3902	1522	26	1	0	27	1	0.037037037037037035
3903	1477	25	0	0	25	0	0
3904	1535	26	0	0	26	0	0
3905	1532	38	1	0	39	1	0.02564102564102564
3906	1517	29	1	0	30	1	0.03333333333333333
3907	1484	28	2	0	30	2	0.06666666666666667
3908	1495	30	1	0	31	1	0.03225806451612903
3909	1499	24	2	0	26	2	0.07692307692307693
391	1524	29	3	0	32	3	0.09375
3910	1524	26	0	0	26	0	0
3911	1533	28	1	0	29	1	0.034482758620689655
3912	1534	29	0	0	29	0	0
3913	1497	28	0	0	28	0	0
3914	1512	34	1	0	35	1	0.02857142857142857
3915	1493	24	2	0	26	2	0.07692307692307693
3916	1497	29	1	0	30	1	0.03333333333333333
3917	1503	32	0	0	32	0	0
3918	1505	37	0	0	37	0	0
3919	1498	32	1	0	33	1	0.030303030303030304
392	1522	40	2	0	42	2	0.047619047619047616
3920	1539	28	2	0	30	2	0.06666666666666667
3921	1515	36	2	0	38	2	0.05263157894736842
3922	1496	30	1	0	31	1	0.03225806451612903
3923	1526	34	1	0	35	1	0.02857142857142857
3924	1478	23	0	0	23	0	0
3925	1486	22	1	0	23	1	0.043478260869565216
3926	1513	19	1	0	20	1	0.05
3927	1502	34	3	0	37	3	0.08108108108108109
3928	1522	35	1	0	36	1	0.027777777777777776
3929	1534	26	3	0	29	3	0.10344827586206896
393	1495	27	0	0	27	0	0
3930	1515	37	0	0	37	0	0
3931	1493	32	1	0	33	1	0.030303030303030304
3932	1489	24	0	0	24	0	0
3933	1497	34	2	0	36	2	0.05555555555555555
3934	1541	31	2	0	33	2	0.06060606060606061
3935	1519	35	0	0	35	0	0
3936	1500	33	3	0	36	3	0.08333333333333333
3937	1518	23	3	0	26	3	0.11538461538461539
3938	1481	30	0	0	30	0	0
3939	1526	36	1	0	37	1	0.02702702702702703
394	1502	28	1	0	29	1	0.034482758620689655
3940	1525	25	2	0	27	2	0.07407407407407407
3941	1524	32	2	0	34	2	0.058823529411764705
3942	1508	26	2	0	28	2	0.07142857142857142
3943	1509	35	1	0	36	1	0.027777777777777776
3944	1523	24	1	0	25	1	0.04
3945	1491	27	2	0	29	2	0.06896551724137931
3946	1496	36	2	0	38	2	0.05263157894736842
3947	1504	23	1	0	24	1	0.041666666666666664
3948	1483	40	0	0	40	0	0
3949	1522	41	0	0	41	0	0
395	1549	37	0	0	37	0	0
3950	1538	42	1	0	43	1	0.023255813953488372
3951	1485	34	2	0	36	2	0.05555555555555555
3952	1510	26	0	0	26	0	0
3953	1519	34	0	0	34	0	0
3954	1504	39	2	0	41	2	0.04878048780487805
3955	1489	22	0	0	22	0	0
3956	1515	23	2	0	25	2	0.08
3957	1521	26	0	0	26	0	0
3958	1462	25	2	0	27	2	0.07407407407407407
3959	1526	38	0	0	38	0	0
396	1485	31	0	0	31	0	0
3960	1515	33	1	0	34	1	0.029411764705882353
3961	1520	16	1	0	17	1	0.058823529411764705
3962	1512	28	2	0	30	2	0.06666666666666667
3963	1513	23	0	0	23	0	0
3964	1499	30	1	0	31	1	0.03225806451612903
3965	1492	29	2	0	31	2	0.06451612903225806
3966	1505	27	1	0	28	1	0.03571428571428571
3967	1495	28	0	0	28	0	0
3968	1513	32	0	0	32	0	0
3969	1513	38	2	0	40	2	0.05
397	1493	34	1	0	35	1	0.02857142857142857
3970	1513	29	0	0	29	0	0
3971	1499	35	1	0	36	1	0.027777777777777776
3972	1506	37	0	0	37	0	0
3973	1536	32	1	0	33	1	0.030303030303030304
3974	1530	29	0	0	29	0	0
3975	1499	27	1	0	28	1	0.03571428571428571
3976	1562	29	0	0	29	0	0
3977	1496	28	0	1	29	1	0.034482758620689655
3978	1468	36	1	0	37	1	0.02702702702702703
3979	1494	43	1	0	44	1	0.022727272727272728
398	1530	30	1	0	31	1	0.03225806451612903
3980	1529	32	1	0	33	1	0.030303030303030304
3981	1522	31	1	0	32	1	0.03125
3982	1527	43	1	0	44	1	0.022727272727272728
3983	1507	30	0	0	30	0	0
3984	1529	34	1	0	35	1	0.02857142857142857
3985	1541	24	0	0	24	0	0
3986	1515	24	1	0	25	1	0.04
3987	1488	22	2	0	24	2	0.08333333333333333
3988	1492	17	2	0	19	2	0.10526315789473684
3989	1506	27	2	0	29	2	0.06896551724137931
399	1519	29	0	0	29	0	0
3990	1497	31	0	0	31	0	0
3991	1506	39	1	0	40	1	0.025
3992	1502	35	0	0	35	0	0
3993	1527	23	2	0	25	2	0.08
3994	1521	34	0	0	34	0	0
3995	1513	31	1	0	32	1	0.03125
3996	1504	31	1	0	32	1	0.03125
3997	1475	28	1	0	29	1	0.034482758620689655
3998	1473	35	0	0	35	0	0
3999	1514	32	0	0	32	0	0
4	1525	35	0	0	35	0	0
40	1493	28	0	0	28	0	0
400	1480	25	2	0	27	2	0.07407407407407407
4000	1506	29	0	0	29	0	0
4001	1492	39	1	0	40	1	0.025
4002	1500	26	0	0	26	0	0
4003	1501	34	0	0	34	0	0
4004	1515	29	0	0	29	0	0
4005	1508	40	2	0	42	2	0.047619047619047616
4006	1502	36	2	0	38	2	0.05263157894736842
4007	1512	29	3	0	32	3	0.09375
4008	1499	26	1	0	27	1	0.037037037037037035
4009	1523	26	1	0	27	1	0.037037037037037035
401	1514	43	0	0	43	0	0
4010	1517	35	1	0	36	1	0.027777777777777776
4011	1499	28	0	0	28	0	0
4012	1506	24	1	0	25	1	0.04
4013	1530	27	2	0	29	2	0.06896551724137931
4014	1457	29	2	0	31	2	0.06451612903225806
4015	1532	41	0	0	41	0	0
4016	1523	44	1	0	45	1	0.022222222222222223
4017	1518	36	0	0	36	0	0
4018	1516	26	1	0	27	1	0.037037037037037035
4019	1530	22	1	0	23	1	0.043478260869565216
402	1522	30	1	0	31	1	0.03225806451612903
4020	1519	30	1	0	31	1	0.03225806451612903
4021	1532	29	0	0	29	0	0
4022	1467	32	1	0	33	1	0.030303030303030304
4023	1546	23	1	0	24	1	0.041666666666666664
4024	1509	29	0	0	29	0	0
4025	1502	33	1	0	34	1	0.029411764705882353
4026	1521	19	0	0	19	0	0
4027	1521	39	1	0	40	1	0.025
4028	1538	31	1	0	32	1	0.03125
4029	1516	25	0	0	25	0	0
403	1490	39	0	0	39	0	0
4030	1540	26	1	0	27	1	0.037037037037037035
4031	1517	27	1	0	28	1	0.03571428571428571
4032	1529	31	1	0	32	1	0.03125
4033	1531	36	1	0	37	1	0.02702702702702703
4034	1521	30	1	0	31	1	0.03225806451612903
4035	1507	32	2	0	34	2	0.058823529411764705
4036	1551	28	0	0	28	0	0
4037	1519	29	1	0	30	1	0.03333333333333333
4038	1533	29	0	0	29	0	0
4039	1484	37	0	0	37	0	0
404	1485	27	2	0	29	2	0.06896551724137931
4040	1546	21	3	0	24	3	0.125
4041	1497	31	1	0	32	1	0.03125
4042	1472	22	0	0	22	0	0
4043	1511	29	0	0	29	0	0
4044	1524	22	1	0	23	1	0.043478260869565216
4045	1501	34	0	0	34	0	0
4046	1528	21	0	0	21	0	0
4047	1527	30	1	0	31	1	0.03225806451612903
4048	1526	31	1	0	32	1	0.03125
4049	1513	27	1	0	28	1	0.03571428571428571
405	1517	30	1	0	31	1	0.03225806451612903
4050	1503	35	2	0	37	2	0.05405405405405406
4051	1527	25	1	0	26	1	0.038461538461538464
4052	1479	38	1	0	39	1	0.02564102564102564
4053	1527	29	1	0	30	1	0.03333333333333333
4054	1551	34	1	0	35	1	0.02857142857142857
4055	1538	32	1	0	33	1	0.030303030303030304
4056	1517	40	1	0	41	1	0.024390243902439025
4057	1514	31	0	0	31	0	0
4058	1544	38	2	0	40	2	0.05
4059	1531	22	1	0	23	1	0.043478260869565216
406	1495	38	4	0	42	4	0.09523809523809523
4060	1493	36	1	0	37	1	0.02702702702702703
4061	1508	26	0	0	26	0	0
4062	1515	28	0	0	28	0	0
4063	1533	29	2	0	31	2	0.06451612903225806
4064	1514	33	1	0	34	1	0.029411764705882353
4065	1505	29	3	0	32	3	0.09375
4066	1482	28	0	0	28	0	0
4067	1515	41	1	0	42	1	0.023809523809523808
4068	1510	35	1	0	36	1	0.027777777777777776
4069	1500	24	1	0	25	1	0.04
407	1514	25	0	0	25	0	0
4070	1526	43	1	0	44	1	0.022727272727272728
4071	1480	27	0	0	27	0	0
4072	1514	22	1	0	23	1	0.043478260869565216
4073	1523	29	0	0	29	0	0
4074	1521	33	0	0	33	0	0
4075	1523	32	0	0	32	0	0
4076	1503	32	0	0	32	0	0
4077	1511	30	1	0	31	1	0.03225806451612903
4078	1508	35	0	0	35	0	0
4079	1497	37	1	0	38	1	0.02631578947368421
408	1521	35	2	0	37	2	0.05405405405405406
4080	1522	33	3	0	36	3	0.08333333333333333
4081	1545	27	0	0	27	0	0
4082	1500	22	0	0	22	0	0
4083	1516	22	0	0	22	0	0
4084	1543	28	2	0	30	2	0.06666666666666667
4085	1473	28	1	0	29	1	0.034482758620689655
4086	1509	23	0	0	23	0	0
4087	1505	26	1	0	27	1	0.037037037037037035
4088	1498	32	1	0	33	1	0.030303030303030304
4089	1515	28	1	0	29	1	0.034482758620689655
409	1517	32	1	0	33	1	0.030303030303030304
4090	1540	25	2	0	27	2	0.07407407407407407
4091	1510	28	0	0	28	0	0
4092	1507	22	1	0	23	1	0.043478260869565216
4093	1480	31	1	0	32	1	0.03125
4094	1536	23	0	0	23	0	0
4095	1500	31	0	0	31	0	0
4096	1529	31	3	0	34	3	0.08823529411764706
4097	1518	28	1	0	29	1	0.034482758620689655
4098	1506	31	1	0	32	1	0.03125
4099	1508	32	1	0	33	1	0.030303030303030304
41	1533	36	2	0	38	2	0.05263157894736842
410	1518	24	0	0	24	0	0
4100	1535	27	0	0	27	0	0
4101	1518	26	4	0	30	4	0.13333333333333333
4102	1526	27	1	0	28	1	0.03571428571428571
4103	1521	32	2	0	34	2	0.058823529411764705
4104	1516	40	2	0	42	2	0.047619047619047616
4105	1504	30	1	0	31	1	0.03225806451612903
4106	1509	36	1	0	37	1	0.02702702702702703
4107	1520	31	0	0	31	0	0
4108	1524	33	3	0	36	3	0.08333333333333333
4109	1483	31	4	0	35	4	0.11428571428571428
411	1503	40	2	0	42	2	0.047619047619047616
4110	1468	35	0	0	35	0	0
4111	1476	33	2	0	35	2	0.05714285714285714
4112	1485	32	0	0	32	0	0
4113	1522	35	1	0	36	1	0.027777777777777776
4114	1515	35	0	0	35	0	0
4115	1502	33	0	0	33	0	0
4116	1525	29	2	0	31	2	0.06451612903225806
4117	1497	33	1	0	34	1	0.029411764705882353
4118	1476	31	0	0	31	0	0
4119	1513	30	1	0	31	1	0.03225806451612903
412	1532	27	1	0	28	1	0.03571428571428571
4120	1503	34	2	0	36	2	0.05555555555555555
4121	1518	27	0	0	27	0	0
4122	1495	41	0	0	41	0	0
4123	1524	29	2	0	31	2	0.06451612903225806
4124	1533	30	0	0	30	0	0
4125	1512	37	0	0	37	0	0
4126	1520	37	2	0	39	2	0.05128205128205128
4127	1485	29	0	0	29	0	0
4128	1500	33	1	0	34	1	0.029411764705882353
4129	1533	21	1	0	22	1	0.045454545454545456
413	1493	29	0	1	30	1	0.03333333333333333
4130	1506	31	1	0	32	1	0.03125
4131	1516	43	1	0	44	1	0.022727272727272728
4132	1499	32	1	0	33	1	0.030303030303030304
4133	1498	35	0	0	35	0	0
4134	1483	25	2	0	27	2	0.07407407407407407
4135	1507	44	2	0	46	2	0.043478260869565216
4136	1500	32	0	0	32	0	0
4137	1521	33	1	0	34	1	0.029411764705882353
4138	1540	30	1	0	31	1	0.03225806451612903
4139	1513	28	1	0	29	1	0.034482758620689655
414	1552	36	0	0	36	0	0
4140	1511	33	1	0	34	1	0.029411764705882353
4141	1522	18	2	0	20	2	0.1
4142	1502	27	1	0	28	1	0.03571428571428571
4143	1535	29	0	0	29	0	0
4144	1521	30	1	0	31	1	0.03225806451612903
4145	1501	40	3	0	43	3	0.06976744186046512
4146	1499	30	1	0	31	1	0.03225806451612903
4147	1471	36	1	0	37	1	0.02702702702702703
4148	1532	19	1	0	20	1	0.05
4149	1516	24	1	0	25	1	0.04
415	1494	32	0	0	32	0	0
4150	1513	24	1	0	25	1	0.04
4151	1527	31	0	0	31	0	0
4152	1517	30	0	0	30	0	0
4153	1471	27	1	0	28	1	0.03571428571428571
4154	1520	34	2	0	36	2	0.05555555555555555
4155	1468	37	2	0	39	2	0.05128205128205128
4156	1530	30	0	0	30	0	0
4157	1504	27	1	0	28	1	0.03571428571428571
4158	1521	38	0	0	38	0	0
4159	1505	31	1	0	32	1	0.03125
416	1481	36	1	0	37	1	0.02702702702702703
4160	1522	15	2	0	17	2	0.11764705882352941
4161	1503	41	2	0	43	2	0.046511627906976744
4162	1489	37	1	0	38	1	0.02631578947368421
4163	1513	31	2	0	33	2	0.06060606060606061
4164	1510	31	2	0	33	2	0.06060606060606061
4165	1523	28	1	0	29	1	0.034482758620689655
4166	1540	33	2	0	35	2	0.05714285714285714
4167	1496	30	0	0	30	0	0
4168	1536	26	0	0	26	0	0
4169	1484	28	1	0	29	1	0.034482758620689655
417	1489	31	0	0	31	0	0
4170	1528	21	0	0	21	0	0
4171	1501	31	1	0	32	1	0.03125
4172	1506	29	2	0	31	2	0.06451612903225806
4173	1482	31	1	0	32	1	0.03125
4174	1502	26	0	0	26	0	0
4175	1495	31	0	0	31	0	0
4176	1511	34	2	0	36	2	0.05555555555555555
4177	1512	32	2	0	34	2	0.058823529411764705
4178	1487	32	1	0	33	1	0.030303030303030304
4179	1486	34	1	0	35	1	0.02857142857142857
418	1500	24	2	0	26	2	0.07692307692307693
4180	1491	32	1	0	33	1	0.030303030303030304
4181	1530	31	3	0	34	3	0.08823529411764706
4182	1537	29	1	0	30	1	0.03333333333333333
4183	1493	33	1	0	34	1	0.029411764705882353
4184	1483	24	0	0	24	0	0
4185	1509	30	0	0	30	0	0
4186	1529	33	1	0	34	1	0.029411764705882353
4187	1522	21	0	0	21	0	0
4188	1517	27	1	0	28	1	0.03571428571428571
4189	1484	32	1	0	33	1	0.030303030303030304
419	1492	32	0	0	32	0	0
4190	1530	26	2	0	28	2	0.07142857142857142
4191	1515	24	1	0	25	1	0.04
4192	1513	34	0	0	34	0	0
4193	1517	36	0	0	36	0	0
4194	1481	32	1	0	33	1	0.030303030303030304
4195	1496	35	3	0	38	3	0.07894736842105263
4196	1522	28	0	0	28	0	0
4197	1472	28	2	0	30	2	0.06666666666666667
4198	1534	29	1	0	30	1	0.03333333333333333
4199	1519	28	1	0	29	1	0.034482758620689655
42	1511	33	1	0	34	1	0.029411764705882353
420	1502	32	0	0	32	0	0
4200	1544	35	2	0	37	2	0.05405405405405406
4201	1494	31	0	0	31	0	0
4202	1499	40	0	0	40	0	0
4203	1510	23	0	0	23	0	0
4204	1551	26	2	0	28	2	0.07142857142857142
4205	1516	26	1	0	27	1	0.037037037037037035
4206	1466	33	1	0	34	1	0.029411764705882353
4207	1521	29	1	0	30	1	0.03333333333333333
4208	1533	28	0	1	29	1	0.034482758620689655
4209	1539	34	0	0	34	0	0
421	1534	32	0	0	32	0	0
4210	1529	32	1	0	33	1	0.030303030303030304
4211	1476	39	0	0	39	0	0
4212	1515	34	0	0	34	0	0
4213	1519	27	1	0	28	1	0.03571428571428571
4214	1512	27	2	0	29	2	0.06896551724137931
4215	1480	36	1	0	37	1	0.02702702702702703
4216	1533	31	1	0	32	1	0.03125
4217	1493	28	0	0	28	0	0
4218	1531	16	1	0	17	1	0.058823529411764705
4219	1549	35	2	0	37	2	0.05405405405405406
422	1492	32	1	0	33	1	0.030303030303030304
4220	1527	28	0	0	28	0	0
4221	1503	28	0	0	28	0	0
4222	1523	35	1	0	36	1	0.027777777777777776
4223	1509	28	0	0	28	0	0
4224	1485	27	2	0	29	2	0.06896551724137931
4225	1488	28	1	0	29	1	0.034482758620689655
4226	1485	34	0	0	34	0	0
4227	1494	27	2	0	29	2	0.06896551724137931
4228	1506	26	2	0	28	2	0.07142857142857142
4229	1497	34	1	0	35	1	0.02857142857142857
423	1545	30	1	0	31	1	0.03225806451612903
4230	1480	28	0	0	28	0	0
4231	1523	30	2	0	32	2	0.0625
4232	1534	31	1	0	32	1	0.03125
4233	1530	35	3	0	38	3	0.07894736842105263
4234	1527	35	0	0	35	0	0
4235	1506	27	0	0	27	0	0
4236	1514	33	0	0	33	0	0
4237	1503	39	1	0	40	1	0.025
4238	1513	33	0	0	33	0	0
4239	1529	30	1	0	31	1	0.03225806451612903
424	1511	34	1	0	35	1	0.02857142857142857
4240	1474	37	0	0	37	0	0
4241	1473	37	0	0	37	0	0
4242	1530	29	0	0	29	0	0
4243	1526	33	1	1	35	2	0.05714285714285714
4244	1500	27	1	0	28	1	0.03571428571428571
4245	1509	30	1	0	31	1	0.03225806451612903
4246	1497	34	0	0	34	0	0
4247	1499	31	1	0	32	1	0.03125
4248	1520	27	0	0	27	0	0
4249	1499	29	0	0	29	0	0
425	1514	32	1	0	33	1	0.030303030303030304
4250	1548	37	1	0	38	1	0.02631578947368421
4251	1487	39	3	0	42	3	0.07142857142857142
4252	1514	30	0	0	30	0	0
4253	1511	41	0	0	41	0	0
4254	1515	33	0	0	33	0	0
4255	1522	40	1	0	41	1	0.024390243902439025
4256	1512	35	0	0	35	0	0
4257	1509	22	0	0	22	0	0
4258	1464	27	0	0	27	0	0
4259	1517	44	0	0	44	0	0
426	1520	35	2	0	37	2	0.05405405405405406
4260	1516	28	0	0	28	0	0
4261	1522	36	1	0	37	1	0.02702702702702703
4262	1523	26	2	0	28	2	0.07142857142857142
4263	1487	26	1	0	27	1	0.037037037037037035
4264	1530	29	0	0	29	0	0
4265	1491	25	1	0	26	1	0.038461538461538464
4266	1515	26	1	0	27	1	0.037037037037037035
4267	1511	30	3	0	33	3	0.09090909090909091
4268	1498	34	0	0	34	0	0
4269	1509	31	1	0	32	1	0.03125
427	1494	35	3	0	38	3	0.07894736842105263
4270	1510	31	0	0	31	0	0
4271	1502	27	1	0	28	1	0.03571428571428571
4272	1507	29	1	0	30	1	0.03333333333333333
4273	1499	23	2	0	25	2	0.08
4274	1487	24	1	0	25	1	0.04
4275	1501	21	2	0	23	2	0.08695652173913043
4276	1499	34	0	0	34	0	0
4277	1496	32	0	0	32	0	0
4278	1525	39	0	0	39	0	0
4279	1528	34	1	0	35	1	0.02857142857142857
428	1553	25	1	0	26	1	0.038461538461538464
4280	1521	35	1	0	36	1	0.027777777777777776
4281	1504	28	0	0	28	0	0
4282	1513	23	1	0	24	1	0.041666666666666664
4283	1483	29	2	0	31	2	0.06451612903225806
4284	1516	21	0	0	21	0	0
4285	1499	36	0	0	36	0	0
4286	1490	34	1	0	35	1	0.02857142857142857
4287	1532	29	0	0	29	0	0
4288	1529	29	1	0	30	1	0.03333333333333333
4289	1500	32	1	0	33	1	0.030303030303030304
429	1550	29	0	0	29	0	0
4290	1493	31	0	0	31	0	0
4291	1488	29	1	0	30	1	0.03333333333333333
4292	1508	33	2	0	35	2	0.05714285714285714
4293	1520	30	1	0	31	1	0.03225806451612903
4294	1519	27	2	0	29	2	0.06896551724137931
4295	1501	32	0	0	32	0	0
4296	1491	35	0	0	35	0	0
4297	1525	36	2	0	38	2	0.05263157894736842
4298	1489	24	1	0	25	1	0.04
4299	1540	25	1	0	26	1	0.038461538461538464
43	1505	21	0	0	21	0	0
430	1541	28	0	0	28	0	0
4300	1505	25	0	0	25	0	0
4301	1500	33	0	0	33	0	0
4302	1537	28	0	0	28	0	0
4303	1539	25	0	0	25	0	0
4304	1504	33	2	0	35	2	0.05714285714285714
4305	1484	32	0	0	32	0	0
4306	1520	28	0	0	28	0	0
4307	1502	35	0	0	35	0	0
4308	1488	28	0	0	28	0	0
4309	1574	36	1	0	37	1	0.02702702702702703
431	1447	24	0	0	24	0	0
4310	1493	34	1	0	35	1	0.02857142857142857
4311	1524	38	0	0	38	0	0
4312	1487	25	1	0	26	1	0.038461538461538464
4313	1509	19	0	0	19	0	0
4314	1520	29	0	0	29	0	0
4315	1525	30	2	0	32	2	0.0625
4316	1534	43	1	0	44	1	0.022727272727272728
4317	1495	34	1	0	35	1	0.02857142857142857
4318	1525	31	1	0	32	1	0.03125
4319	1511	31	0	0	31	0	0
432	1525	38	2	0	40	2	0.05
4320	1489	29	1	0	30	1	0.03333333333333333
4321	1495	21	0	0	21	0	0
4322	1513	30	2	0	32	2	0.0625
4323	1502	34	2	0	36	2	0.05555555555555555
4324	1525	19	1	0	20	1	0.05
4325	1481	28	0	0	28	0	0
4326	1507	37	0	0	37	0	0
4327	1529	41	0	0	41	0	0
4328	1527	26	1	0	27	1	0.037037037037037035
4329	1472	37	0	0	37	0	0
433	1519	44	1	0	45	1	0.022222222222222223
4330	1524	20	0	0	20	0	0
4331	1492	28	1	0	29	1	0.034482758620689655
4332	1498	30	1	0	31	1	0.03225806451612903
4333	1529	31	1	0	32	1	0.03125
4334	1552	37	1	0	38	1	0.02631578947368421
4335	1492	23	1	0	24	1	0.041666666666666664
4336	1529	22	0	0	22	0	0
4337	1499	28	2	0	30	2	0.06666666666666667
4338	1508	24	0	0	24	0	0
4339	1547	22	0	0	22	0	0
434	1492	28	1	0	29	1	0.034482758620689655
4340	1490	37	0	0	37	0	0
4341	1515	32	0	0	32	0	0
4342	1511	30	0	0	30	0	0
4343	1480	28	1	0	29	1	0.034482758620689655
4344	1503	20	1	0	21	1	0.047619047619047616
4345	1497	41	0	0	41	0	0
4346	1503	24	2	0	26	2	0.07692307692307693
4347	1496	30	0	0	30	0	0
4348	1472	28	0	0	28	0	0
4349	1540	26	0	0	26	0	0
435	1523	38	2	0	40	2	0.05
4350	1518	25	2	0	27	2	0.07407407407407407
4351	1488	20	1	0	21	1	0.047619047619047616
4352	1494	25	0	0	25	0	0
4353	1492	35	1	0	36	1	0.027777777777777776
4354	1526	25	0	0	25	0	0
4355	1481	41	1	0	42	1	0.023809523809523808
4356	1513	30	1	0	31	1	0.03225806451612903
4357	1531	35	0	0	35	0	0
4358	1509	35	2	0	37	2	0.05405405405405406
4359	1506	33	3	0	36	3	0.08333333333333333
436	1499	37	0	0	37	0	0
4360	1481	39	0	0	39	0	0
4361	1490	28	3	0	31	3	0.0967741935483871
4362	1515	27	1	0	28	1	0.03571428571428571
4363	1526	32	1	0	33	1	0.030303030303030304
4364	1503	35	1	0	36	1	0.027777777777777776
4365	1501	24	1	0	25	1	0.04
4366	1560	27	1	0	28	1	0.03571428571428571
4367	1492	30	0	0	30	0	0
4368	1523	31	1	0	32	1	0.03125
4369	1499	34	1	0	35	1	0.02857142857142857
437	1533	27	0	0	27	0	0
4370	1513	35	3	0	38	3	0.07894736842105263
4371	1515	23	1	0	24	1	0.041666666666666664
4372	1488	24	1	0	25	1	0.04
4373	1513	35	0	0	35	0	0
4374	1510	27	0	0	27	0	0
4375	1484	27	2	0	29	2	0.06896551724137931
4376	1472	32	2	0	34	2	0.058823529411764705
4377	1492	27	0	1	28	1	0.03571428571428571
4378	1525	33	1	0	34	1	0.029411764705882353
4379	1527	34	0	0	34	0	0
438	1507	27	2	0	29	2	0.06896551724137931
4380	1503	22	4	0	26	4	0.15384615384615385
4381	1509	27	1	0	28	1	0.03571428571428571
4382	1501	31	0	0	31	0	0
4383	1488	24	0	0	24	0	0
4384	1474	33	0	0	33	0	0
4385	1516	29	1	0	30	1	0.03333333333333333
4386	1528	36	2	0	38	2	0.05263157894736842
4387	1522	30	1	0	31	1	0.03225806451612903
4388	1482	32	0	0	32	0	0
4389	1506	27	1	0	28	1	0.03571428571428571
439	1529	22	0	0	22	0	0
4390	1523	34	0	0	34	0	0
4391	1487	28	0	0	28	0	0
4392	1522	37	1	0	38	1	0.02631578947368421
4393	1471	33	2	0	35	2	0.05714285714285714
4394	1544	32	1	0	33	1	0.030303030303030304
4395	1501	27	1	0	28	1	0.03571428571428571
4396	1506	26	0	0	26	0	0
4397	1519	29	1	0	30	1	0.03333333333333333
4398	1512	38	0	0	38	0	0
4399	1506	26	0	0	26	0	0
44	1505	22	3	0	25	3	0.12
440	1506	26	2	0	28	2	0.07142857142857142
4400	1530	23	2	0	25	2	0.08
4401	1511	31	1	0	32	1	0.03125
4402	1527	31	1	0	32	1	0.03125
4403	1484	21	1	0	22	1	0.045454545454545456
4404	1504	31	0	0	31	0	0
4405	1514	33	0	0	33	0	0
4406	1516	30	1	0	31	1	0.03225806451612903
4407	1500	28	0	0	28	0	0
4408	1511	29	3	0	32	3	0.09375
4409	1516	28	0	0	28	0	0
441	1517	33	0	0	33	0	0
4410	1522	24	0	0	24	0	0
4411	1521	25	0	0	25	0	0
4412	1513	34	1	0	35	1	0.02857142857142857
4413	1548	37	0	0	37	0	0
4414	1515	32	2	0	34	2	0.058823529411764705
4415	1491	38	2	0	40	2	0.05
4416	1513	23	2	0	25	2	0.08
4417	1520	40	2	0	42	2	0.047619047619047616
4418	1509	29	0	0	29	0	0
4419	1502	32	1	0	33	1	0.030303030303030304
442	1517	39	2	0	41	2	0.04878048780487805
4420	1520	44	3	0	47	3	0.06382978723404255
4421	1495	35	1	0	36	1	0.027777777777777776
4422	1493	28	1	0	29	1	0.034482758620689655
4423	1504	35	0	0	35	0	0
4424	1509	30	2	0	32	2	0.0625
4425	1488	39	0	0	39	0	0
4426	1531	22	1	0	23	1	0.043478260869565216
4427	1503	35	1	0	36	1	0.027777777777777776
4428	1499	26	2	0	28	2	0.07142857142857142
4429	1497	36	0	0	36	0	0
443	1527	29	1	0	30	1	0.03333333333333333
4430	1532	29	2	0	31	2	0.06451612903225806
4431	1515	37	2	0	39	2	0.05128205128205128
4432	1555	25	0	0	25	0	0
4433	1479	33	1	0	34	1	0.029411764705882353
4434	1535	33	1	0	34	1	0.029411764705882353
4435	1503	26	1	0	27	1	0.037037037037037035
4436	1489	26	0	0	26	0	0
4437	1534	33	0	0	33	0	0
4438	1515	43	1	0	44	1	0.022727272727272728
4439	1520	27	1	0	28	1	0.03571428571428571
444	1532	26	2	0	28	2	0.07142857142857142
4440	1502	29	1	0	30	1	0.03333333333333333
4441	1501	29	0	0	29	0	0
4442	1498	32	1	0	33	1	0.030303030303030304
4443	1513	29	0	0	29	0	0
4444	1481	32	2	0	34	2	0.058823529411764705
4445	1535	20	2	1	23	3	0.13043478260869565
4446	1519	27	0	0	27	0	0
4447	1509	36	1	0	37	1	0.02702702702702703
4448	1528	38	1	0	39	1	0.02564102564102564
4449	1514	39	1	0	40	1	0.025
445	1503	32	0	0	32	0	0
4450	1511	39	1	0	40	1	0.025
4451	1506	32	0	0	32	0	0
4452	1534	21	1	0	22	1	0.045454545454545456
4453	1512	24	0	0	24	0	0
4454	1480	33	1	0	34	1	0.029411764705882353
4455	1503	30	0	0	30	0	0
4456	1511	40	2	0	42	2	0.047619047619047616
4457	1529	36	0	0	36	0	0
4458	1516	31	0	0	31	0	0
4459	1524	41	2	0	43	2	0.046511627906976744
446	1503	33	1	0	34	1	0.029411764705882353
4460	1491	33	1	0	34	1	0.029411764705882353
4461	1530	24	1	0	25	1	0.04
4462	1508	35	0	0	35	0	0
4463	1507	21	0	0	21	0	0
4464	1534	31	0	0	31	0	0
4465	1513	28	1	0	29	1	0.034482758620689655
4466	1524	28	0	0	28	0	0
4467	1497	32	0	0	32	0	0
4468	1479	25	0	0	25	0	0
4469	1497	36	1	0	37	1	0.02702702702702703
447	1497	38	2	1	41	3	0.07317073170731707
4470	1545	42	0	0	42	0	0
4471	1522	32	0	0	32	0	0
4472	1500	31	1	0	32	1	0.03125
4473	1511	30	3	0	33	3	0.09090909090909091
4474	1536	41	0	0	41	0	0
4475	1491	29	2	0	31	2	0.06451612903225806
4476	1524	34	0	0	34	0	0
4477	1475	35	2	0	37	2	0.05405405405405406
4478	1503	33	0	0	33	0	0
4479	1493	29	0	0	29	0	0
448	1501	29	2	0	31	2	0.06451612903225806
4480	1501	31	2	0	33	2	0.06060606060606061
4481	1522	30	0	0	30	0	0
4482	1522	22	0	0	22	0	0
4483	1518	27	3	1	31	4	0.12903225806451613
4484	1546	25	3	0	28	3	0.10714285714285714
4485	1524	42	1	0	43	1	0.023255813953488372
4486	1491	28	0	0	28	0	0
4487	1492	25	2	0	27	2	0.07407407407407407
4488	1522	33	0	0	33	0	0
4489	1527	36	0	0	36	0	0
449	1508	24	1	0	25	1	0.04
4490	1501	30	0	0	30	0	0
4491	1504	26	0	0	26	0	0
4492	1545	31	0	0	31	0	0
4493	1503	20	0	0	20	0	0
4494	1511	33	1	0	34	1	0.029411764705882353
4495	1527	22	1	0	23	1	0.043478260869565216
4496	1514	33	2	0	35	2	0.05714285714285714
4497	1487	41	1	0	42	1	0.023809523809523808
4498	1482	32	0	0	32	0	0
4499	1486	34	0	0	34	0	0
45	1531	25	1	0	26	1	0.038461538461538464
450	1516	27	0	0	27	0	0
4500	1491	28	1	0	29	1	0.034482758620689655
4501	1518	26	1	0	27	1	0.037037037037037035
4502	1502	37	2	0	39	2	0.05128205128205128
4503	1523	33	1	0	34	1	0.029411764705882353
4504	1471	33	1	0	34	1	0.029411764705882353
4505	1542	33	1	0	34	1	0.029411764705882353
4506	1494	43	2	0	45	2	0.044444444444444446
4507	1538	23	1	0	24	1	0.041666666666666664
4508	1525	35	1	0	36	1	0.027777777777777776
4509	1524	35	1	0	36	1	0.027777777777777776
451	1513	35	0	0	35	0	0
4510	1523	40	0	1	41	1	0.024390243902439025
4511	1522	26	1	0	27	1	0.037037037037037035
4512	1535	37	1	0	38	1	0.02631578947368421
4513	1531	40	0	0	40	0	0
4514	1499	32	1	0	33	1	0.030303030303030304
4515	1506	29	0	0	29	0	0
4516	1527	26	0	0	26	0	0
4517	1542	32	2	0	34	2	0.058823529411764705
4518	1500	27	2	0	29	2	0.06896551724137931
4519	1503	36	1	0	37	1	0.02702702702702703
452	1519	30	0	0	30	0	0
4520	1528	26	1	0	27	1	0.037037037037037035
4521	1508	29	1	0	30	1	0.03333333333333333
4522	1501	36	0	0	36	0	0
4523	1540	36	0	0	36	0	0
4524	1529	30	0	0	30	0	0
4525	1490	37	0	0	37	0	0
4526	1519	25	0	0	25	0	0
4527	1488	37	0	0	37	0	0
4528	1523	28	1	0	29	1	0.034482758620689655
4529	1504	28	1	0	29	1	0.034482758620689655
453	1503	30	4	0	34	4	0.11764705882352941
4530	1512	26	0	0	26	0	0
4531	1515	30	0	0	30	0	0
4532	1466	26	1	0	27	1	0.037037037037037035
4533	1505	35	1	0	36	1	0.027777777777777776
4534	1505	32	1	0	33	1	0.030303030303030304
4535	1490	35	0	0	35	0	0
4536	1480	37	0	0	37	0	0
4537	1522	27	1	0	28	1	0.03571428571428571
4538	1530	22	0	0	22	0	0
4539	1542	29	1	0	30	1	0.03333333333333333
454	1518	31	2	0	33	2	0.06060606060606061
4540	1534	27	1	0	28	1	0.03571428571428571
4541	1510	19	0	0	19	0	0
4542	1487	35	2	0	37	2	0.05405405405405406
4543	1521	31	1	0	32	1	0.03125
4544	1461	31	0	0	31	0	0
4545	1510	37	0	0	37	0	0
4546	1515	35	0	0	35	0	0
4547	1518	19	0	0	19	0	0
4548	1531	32	0	0	32	0	0
4549	1514	28	1	0	29	1	0.034482758620689655
455	1547	26	2	0	28	2	0.07142857142857142
4550	1516	32	1	0	33	1	0.030303030303030304
4551	1490	35	0	0	35	0	0
4552	1517	28	0	0	28	0	0
4553	1516	34	1	0	35	1	0.02857142857142857
4554	1513	25	0	0	25	0	0
4555	1497	36	1	0	37	1	0.02702702702702703
4556	1505	45	0	0	45	0	0
4557	1531	39	2	0	41	2	0.04878048780487805
4558	1516	39	0	0	39	0	0
4559	1497	27	1	0	28	1	0.03571428571428571
456	1499	28	1	0	29	1	0.034482758620689655
4560	1478	36	0	0	36	0	0
4561	1548	40	1	0	41	1	0.024390243902439025
4562	1523	28	0	0	28	0	0
4563	1471	38	3	0	41	3	0.07317073170731707
4564	1537	31	1	0	32	1	0.03125
4565	1486	29	0	0	29	0	0
4566	1507	25	0	0	25	0	0
4567	1499	22	0	0	22	0	0
4568	1506	33	1	0	34	1	0.029411764705882353
4569	1502	27	1	0	28	1	0.03571428571428571
457	1474	32	0	0	32	0	0
4570	1521	35	0	0	35	0	0
4571	1490	36	0	0	36	0	0
4572	1483	30	2	0	32	2	0.0625
4573	1490	35	0	0	35	0	0
4574	1529	46	1	0	47	1	0.02127659574468085
4575	1538	27	0	0	27	0	0
4576	1507	38	2	0	40	2	0.05
4577	1509	31	2	0	33	2	0.06060606060606061
4578	1497	31	0	0	31	0	0
4579	1533	22	1	0	23	1	0.043478260869565216
458	1509	26	0	0	26	0	0
4580	1518	23	0	0	23	0	0
4581	1501	27	0	0	27	0	0
4582	1508	32	3	0	35	3	0.08571428571428572
4583	1483	36	1	0	37	1	0.02702702702702703
4584	1546	28	1	0	29	1	0.034482758620689655
4585	1498	36	0	0	36	0	0
4586	1520	31	1	0	32	1	0.03125
4587	1527	17	4	0	21	4	0.19047619047619047
4588	1518	42	3	0	45	3	0.06666666666666667
4589	1491	25	2	0	27	2	0.07407407407407407
459	1539	22	0	0	22	0	0
4590	1489	32	1	0	33	1	0.030303030303030304
4591	1497	36	1	0	37	1	0.02702702702702703
4592	1495	29	0	0	29	0	0
4593	1510	32	2	0	34	2	0.058823529411764705
4594	1519	24	0	0	24	0	0
4595	1529	24	2	0	26	2	0.07692307692307693
4596	1500	36	0	0	36	0	0
4597	1485	31	0	0	31	0	0
4598	1500	36	0	0	36	0	0
4599	1520	29	1	0	30	1	0.03333333333333333
46	1520	27	5	0	32	5	0.15625
460	1520	31	1	0	32	1	0.03125
4600	1529	33	1	0	34	1	0.029411764705882353
4601	1529	34	0	0	34	0	0
4602	1471	25	0	0	25	0	0
4603	1538	34	2	0	36	2	0.05555555555555555
4604	1485	30	0	0	30	0	0
4605	1514	33	1	0	34	1	0.029411764705882353
4606	1509	36	0	0	36	0	0
4607	1503	32	1	0	33	1	0.030303030303030304
4608	1495	37	1	0	38	1	0.02631578947368421
4609	1520	31	0	0	31	0	0
461	1530	37	0	0	37	0	0
4610	1532	35	1	0	36	1	0.027777777777777776
4611	1531	31	1	0	32	1	0.03125
4612	1526	28	0	0	28	0	0
4613	1526	26	0	0	26	0	0
4614	1501	34	1	0	35	1	0.02857142857142857
4615	1508	29	0	0	29	0	0
4616	1479	24	1	0	25	1	0.04
4617	1488	32	0	0	32	0	0
4618	1528	28	1	0	29	1	0.034482758620689655
4619	1535	38	0	0	38	0	0
462	1508	35	0	0	35	0	0
4620	1537	21	0	0	21	0	0
4621	1522	35	1	0	36	1	0.027777777777777776
4622	1486	26	0	0	26	0	0
4623	1528	31	1	0	32	1	0.03125
4624	1505	36	2	0	38	2	0.05263157894736842
4625	1495	28	0	0	28	0	0
4626	1500	34	1	0	35	1	0.02857142857142857
4627	1488	22	1	0	23	1	0.043478260869565216
4628	1536	31	1	0	32	1	0.03125
4629	1521	32	1	0	33	1	0.030303030303030304
463	1538	28	0	0	28	0	0
4630	1530	27	0	0	27	0	0
4631	1516	24	0	0	24	0	0
4632	1535	21	1	0	22	1	0.045454545454545456
4633	1504	29	2	0	31	2	0.06451612903225806
4634	1526	29	1	0	30	1	0.03333333333333333
4635	1515	33	1	1	35	2	0.05714285714285714
4636	1512	27	1	0	28	1	0.03571428571428571
4637	1529	27	3	0	30	3	0.1
4638	1492	37	0	0	37	0	0
4639	1514	39	2	0	41	2	0.04878048780487805
464	1508	27	0	0	27	0	0
4640	1506	33	1	0	34	1	0.029411764705882353
4641	1505	36	0	0	36	0	0
4642	1515	22	1	0	23	1	0.043478260869565216
4643	1503	23	0	0	23	0	0
4644	1476	35	0	0	35	0	0
4645	1537	33	0	0	33	0	0
4646	1501	36	1	0	37	1	0.02702702702702703
4647	1523	29	1	0	30	1	0.03333333333333333
4648	1530	20	0	0	20	0	0
4649	1506	24	0	0	24	0	0
465	1497	23	2	0	25	2	0.08
4650	1507	22	0	0	22	0	0
4651	1528	26	0	0	26	0	0
4652	1508	32	1	0	33	1	0.030303030303030304
4653	1496	30	1	0	31	1	0.03225806451612903
4654	1484	34	1	0	35	1	0.02857142857142857
4655	1506	30	1	0	31	1	0.03225806451612903
4656	1517	38	1	0	39	1	0.02564102564102564
4657	1547	27	1	0	28	1	0.03571428571428571
4658	1522	31	0	0	31	0	0
4659	1511	22	0	0	22	0	0
466	1576	28	0	0	28	0	0
4660	1529	29	2	0	31	2	0.06451612903225806
4661	1550	27	0	0	27	0	0
4662	1490	30	0	0	30	0	0
4663	1507	30	1	0	31	1	0.03225806451612903
4664	1538	33	1	0	34	1	0.029411764705882353
4665	1540	25	2	0	27	2	0.07407407407407407
4666	1514	31	1	0	32	1	0.03125
4667	1506	30	2	0	32	2	0.0625
4668	1522	29	1	0	30	1	0.03333333333333333
4669	1514	27	0	0	27	0	0
467	1511	23	0	0	23	0	0
4670	1500	33	1	0	34	1	0.029411764705882353
4671	1512	27	2	0	29	2	0.06896551724137931
4672	1518	32	1	0	33	1	0.030303030303030304
4673	1533	30	0	0	30	0	0
4674	1486	27	1	0	28	1	0.03571428571428571
4675	1519	20	1	0	21	1	0.047619047619047616
4676	1493	41	3	0	44	3	0.06818181818181818
4677	1528	31	2	0	33	2	0.06060606060606061
4678	1503	26	0	0	26	0	0
4679	1520	24	1	0	25	1	0.04
468	1509	37	0	0	37	0	0
4680	1514	27	1	0	28	1	0.03571428571428571
4681	1515	31	0	0	31	0	0
4682	1484	27	0	0	27	0	0
4683	1503	45	1	0	46	1	0.021739130434782608
4684	1536	22	0	0	22	0	0
4685	1529	30	0	0	30	0	0
4686	1511	32	0	0	32	0	0
4687	1498	29	2	0	31	2	0.06451612903225806
4688	1507	27	0	0	27	0	0
4689	1508	34	0	0	34	0	0
469	1527	24	0	0	24	0	0
4690	1507	27	2	0	29	2	0.06896551724137931
4691	1505	31	0	0	31	0	0
4692	1484	37	3	0	40	3	0.075
4693	1532	22	2	0	24	2	0.08333333333333333
4694	1515	37	1	0	38	1	0.02631578947368421
4695	1486	35	0	0	35	0	0
4696	1510	24	1	0	25	1	0.04
4697	1541	35	1	0	36	1	0.027777777777777776
4698	1495	35	1	0	36	1	0.027777777777777776
4699	1534	38	1	0	39	1	0.02564102564102564
47	1520	36	2	0	38	2	0.05263157894736842
470	1534	32	0	0	32	0	0
4700	1534	27	1	0	28	1	0.03571428571428571
4701	1502	27	0	0	27	0	0
4702	1517	26	0	0	26	0	0
4703	1477	26	2	0	28	2	0.07142857142857142
4704	1513	24	1	0	25	1	0.04
4705	1467	30	0	0	30	0	0
4706	1562	24	0	0	24	0	0
4707	1512	31	1	0	32	1	0.03125
4708	1532	27	3	0	30	3	0.1
4709	1508	29	0	0	29	0	0
471	1487	24	1	0	25	1	0.04
4710	1516	31	2	0	33	2	0.06060606060606061
4711	1471	41	0	0	41	0	0
4712	1486	42	0	0	42	0	0
4713	1501	23	0	0	23	0	0
4714	1490	24	0	0	24	0	0
4715	1507	32	0	0	32	0	0
4716	1486	28	0	0	28	0	0
4717	1531	29	2	0	31	2	0.06451612903225806
4718	1517	32	1	0	33	1	0.030303030303030304
4719	1506	23	2	0	25	2	0.08
472	1531	20	2	0	22	2	0.09090909090909091
4720	1509	30	1	0	31	1	0.03225806451612903
4721	1486	45	1	0	46	1	0.021739130434782608
4722	1525	32	0	0	32	0	0
4723	1539	28	1	0	29	1	0.034482758620689655
4724	1540	38	0	0	38	0	0
4725	1461	31	2	0	33	2	0.06060606060606061
4726	1494	34	1	0	35	1	0.02857142857142857
4727	1504	27	3	0	30	3	0.1
4728	1520	23	2	0	25	2	0.08
4729	1506	26	1	0	27	1	0.037037037037037035
473	1524	24	0	0	24	0	0
4730	1498	40	2	0	42	2	0.047619047619047616
4731	1525	34	0	0	34	0	0
4732	1492	34	0	0	34	0	0
4733	1501	30	1	0	31	1	0.03225806451612903
4734	1499	37	1	0	38	1	0.02631578947368421
4735	1518	26	1	0	27	1	0.037037037037037035
4736	1518	32	1	0	33	1	0.030303030303030304
4737	1501	35	0	0	35	0	0
4738	1498	29	0	0	29	0	0
4739	1507	34	1	0	35	1	0.02857142857142857
474	1558	30	1	0	31	1	0.03225806451612903
4740	1514	27	1	1	29	2	0.06896551724137931
4741	1567	30	2	0	32	2	0.0625
4742	1529	24	2	0	26	2	0.07692307692307693
4743	1519	31	2	0	33	2	0.06060606060606061
4744	1495	30	0	0	30	0	0
4745	1479	29	2	0	31	2	0.06451612903225806
4746	1526	30	0	0	30	0	0
4747	1532	23	1	0	24	1	0.041666666666666664
4748	1521	39	1	0	40	1	0.025
4749	1551	33	0	0	33	0	0
475	1483	25	2	0	27	2	0.07407407407407407
4750	1476	27	0	0	27	0	0
4751	1504	22	0	0	22	0	0
4752	1505	31	0	0	31	0	0
4753	1505	34	2	0	36	2	0.05555555555555555
4754	1526	21	1	0	22	1	0.045454545454545456
4755	1545	32	1	0	33	1	0.030303030303030304
4756	1517	28	0	0	28	0	0
4757	1490	31	1	0	32	1	0.03125
4758	1490	37	1	0	38	1	0.02631578947368421
4759	1511	27	0	0	27	0	0
476	1493	34	2	0	36	2	0.05555555555555555
4760	1521	24	0	0	24	0	0
4761	1525	24	3	0	27	3	0.1111111111111111
4762	1493	20	0	0	20	0	0
4763	1514	27	1	0	28	1	0.03571428571428571
4764	1504	38	3	0	41	3	0.07317073170731707
4765	1486	31	0	0	31	0	0
4766	1544	31	1	0	32	1	0.03125
4767	1513	32	0	0	32	0	0
4768	1494	36	0	0	36	0	0
4769	1505	40	1	0	41	1	0.024390243902439025
477	1489	29	1	0	30	1	0.03333333333333333
4770	1487	33	0	0	33	0	0
4771	1485	21	0	0	21	0	0
4772	1497	36	0	0	36	0	0
4773	1508	38	2	0	40	2	0.05
4774	1511	42	0	0	42	0	0
4775	1486	34	1	0	35	1	0.02857142857142857
4776	1508	35	0	0	35	0	0
4777	1503	38	2	0	40	2	0.05
4778	1503	20	0	0	20	0	0
4779	1516	35	2	0	37	2	0.05405405405405406
478	1542	25	0	0	25	0	0
4780	1496	24	1	0	25	1	0.04
4781	1539	28	1	0	29	1	0.034482758620689655
4782	1489	30	1	0	31	1	0.03225806451612903
4783	1526	37	1	0	38	1	0.02631578947368421
4784	1521	27	0	0	27	0	0
4785	1527	27	0	0	27	0	0
4786	1481	36	0	0	36	0	0
4787	1514	36	0	0	36	0	0
4788	1511	33	1	0	34	1	0.029411764705882353
4789	1466	38	1	0	39	1	0.02564102564102564
479	1490	37	2	0	39	2	0.05128205128205128
4790	1511	37	0	0	37	0	0
4791	1510	31	0	0	31	0	0
4792	1544	35	0	0	35	0	0
4793	1486	34	1	0	35	1	0.02857142857142857
4794	1526	26	1	0	27	1	0.037037037037037035
4795	1482	30	1	0	31	1	0.03225806451612903
4796	1507	32	0	0	32	0	0
4797	1522	24	1	0	25	1	0.04
4798	1529	33	0	0	33	0	0
4799	1524	25	2	0	27	2	0.07407407407407407
48	1509	26	0	0	26	0	0
480	1523	32	0	0	32	0	0
4800	1510	24	1	0	25	1	0.04
4801	1502	36	0	0	36	0	0
4802	1538	30	2	0	32	2	0.0625
4803	1516	27	0	0	27	0	0
4804	1503	38	2	0	40	2	0.05
4805	1498	32	1	0	33	1	0.030303030303030304
4806	1499	33	1	0	34	1	0.029411764705882353
4807	1521	24	1	0	25	1	0.04
4808	1495	31	1	0	32	1	0.03125
4809	1544	30	1	0	31	1	0.03225806451612903
481	1497	27	0	0	27	0	0
4810	1492	23	2	0	25	2	0.08
4811	1522	23	1	0	24	1	0.041666666666666664
4812	1532	22	0	0	22	0	0
4813	1520	36	0	0	36	0	0
4814	1538	29	3	0	32	3	0.09375
4815	1524	29	0	0	29	0	0
4816	1488	41	0	0	41	0	0
4817	1531	26	2	0	28	2	0.07142857142857142
4818	1499	26	1	0	27	1	0.037037037037037035
4819	1539	30	3	0	33	3	0.09090909090909091
482	1520	37	1	0	38	1	0.02631578947368421
4820	1497	31	2	0	33	2	0.06060606060606061
4821	1525	21	3	0	24	3	0.125
4822	1535	37	0	0	37	0	0
4823	1521	22	0	0	22	0	0
4824	1496	27	0	0	27	0	0
4825	1534	27	1	0	28	1	0.03571428571428571
4826	1513	31	3	0	34	3	0.08823529411764706
4827	1517	23	0	0	23	0	0
4828	1482	22	2	0	24	2	0.08333333333333333
4829	1485	29	1	0	30	1	0.03333333333333333
483	1479	23	1	0	24	1	0.041666666666666664
4830	1524	24	0	0	24	0	0
4831	1504	23	1	0	24	1	0.041666666666666664
4832	1520	35	2	0	37	2	0.05405405405405406
4833	1511	31	0	0	31	0	0
4834	1483	42	0	0	42	0	0
4835	1526	32	0	0	32	0	0
4836	1530	32	1	0	33	1	0.030303030303030304
4837	1520	29	1	0	30	1	0.03333333333333333
4838	1497	26	0	0	26	0	0
4839	1543	28	0	0	28	0	0
484	1513	22	1	0	23	1	0.043478260869565216
4840	1526	34	0	0	34	0	0
4841	1487	28	0	0	28	0	0
4842	1542	26	1	0	27	1	0.037037037037037035
4843	1519	38	0	0	38	0	0
4844	1505	32	1	0	33	1	0.030303030303030304
4845	1514	24	0	0	24	0	0
4846	1483	22	0	0	22	0	0
4847	1512	32	0	0	32	0	0
4848	1492	32	1	0	33	1	0.030303030303030304
4849	1517	30	0	0	30	0	0
485	1492	33	0	0	33	0	0
4850	1522	32	0	0	32	0	0
4851	1484	30	0	0	30	0	0
4852	1473	25	0	0	25	0	0
4853	1525	24	0	0	24	0	0
4854	1529	24	0	0	24	0	0
4855	1527	28	1	0	29	1	0.034482758620689655
4856	1497	29	3	1	33	4	0.12121212121212122
4857	1525	23	2	0	25	2	0.08
4858	1537	30	0	0	30	0	0
4859	1516	20	1	0	21	1	0.047619047619047616
486	1512	20	1	0	21	1	0.047619047619047616
4860	1509	25	0	0	25	0	0
4861	1504	31	1	0	32	1	0.03125
4862	1543	31	0	0	31	0	0
4863	1514	33	0	0	33	0	0
4864	1500	26	0	0	26	0	0
4865	1477	35	1	0	36	1	0.027777777777777776
4866	1482	26	0	0	26	0	0
4867	1532	22	0	0	22	0	0
4868	1483	23	1	0	24	1	0.041666666666666664
4869	1531	20	1	0	21	1	0.047619047619047616
487	1508	35	0	0	35	0	0
4870	1496	27	1	0	28	1	0.03571428571428571
4871	1503	24	2	0	26	2	0.07692307692307693
4872	1512	33	0	0	33	0	0
4873	1506	28	0	0	28	0	0
4874	1513	24	0	0	24	0	0
4875	1533	26	0	0	26	0	0
4876	1512	22	1	0	23	1	0.043478260869565216
4877	1485	30	2	0	32	2	0.0625
4878	1501	34	0	0	34	0	0
4879	1495	44	0	0	44	0	0
488	1539	32	0	0	32	0	0
4880	1509	28	1	0	29	1	0.034482758620689655
4881	1537	31	0	0	31	0	0
4882	1491	30	0	0	30	0	0
4883	1490	28	1	0	29	1	0.034482758620689655
4884	1506	39	3	0	42	3	0.07142857142857142
4885	1525	43	1	0	44	1	0.022727272727272728
4886	1477	29	0	0	29	0	0
4887	1524	43	2	0	45	2	0.044444444444444446
4888	1521	26	1	0	27	1	0.037037037037037035
4889	1500	29	0	0	29	0	0
489	1519	32	0	0	32	0	0
4890	1482	41	0	0	41	0	0
4891	1511	39	3	0	42	3	0.07142857142857142
4892	1517	30	0	0	30	0	0
4893	1516	32	0	0	32	0	0
4894	1516	32	0	0	32	0	0
4895	1518	29	1	0	30	1	0.03333333333333333
4896	1513	23	1	0	24	1	0.041666666666666664
4897	1518	32	1	0	33	1	0.030303030303030304
4898	1494	36	2	0	38	2	0.05263157894736842
4899	1500	25	1	0	26	1	0.038461538461538464
49	1494	35	0	0	35	0	0
490	1497	32	0	0	32	0	0
4900	1500	28	0	0	28	0	0
4901	1518	28	2	0	30	2	0.06666666666666667
4902	1497	34	0	0	34	0	0
4903	1503	33	3	0	36	3	0.08333333333333333
4904	1517	34	1	0	35	1	0.02857142857142857
4905	1507	30	0	0	30	0	0
4906	1538	27	1	0	28	1	0.03571428571428571
4907	1531	41	0	0	41	0	0
4908	1532	25	1	0	26	1	0.038461538461538464
4909	1539	40	1	0	41	1	0.024390243902439025
491	1525	31	0	0	31	0	0
4910	1533	29	1	0	30	1	0.03333333333333333
4911	1525	26	0	0	26	0	0
4912	1505	35	0	0	35	0	0
4913	1525	24	0	0	24	0	0
4914	1518	26	1	0	27	1	0.037037037037037035
4915	1522	30	1	0	31	1	0.03225806451612903
4916	1471	43	2	0	45	2	0.044444444444444446
4917	1535	28	0	0	28	0	0
4918	1495	27	0	0	27	0	0
4919	1494	29	0	0	29	0	0
492	1495	27	0	0	27	0	0
4920	1523	26	3	0	29	3	0.10344827586206896
4921	1503	33	0	0	33	0	0
4922	1475	39	2	0	41	2	0.04878048780487805
4923	1528	21	2	0	23	2	0.08695652173913043
4924	1534	33	0	0	33	0	0
4925	1509	25	0	0	25	0	0
4926	1489	25	1	0	26	1	0.038461538461538464
4927	1526	26	1	0	27	1	0.037037037037037035
4928	1514	28	0	0	28	0	0
4929	1532	34	0	0	34	0	0
493	1537	27	1	0	28	1	0.03571428571428571
4930	1514	41	0	0	41	0	0
4931	1472	27	0	0	27	0	0
4932	1519	31	2	0	33	2	0.06060606060606061
4933	1508	39	1	0	40	1	0.025
4934	1538	27	1	0	28	1	0.03571428571428571
4935	1500	31	0	0	31	0	0
4936	1529	24	0	0	24	0	0
4937	1496	40	4	0	44	4	0.09090909090909091
4938	1517	27	0	0	27	0	0
4939	1519	34	0	1	35	1	0.02857142857142857
494	1485	25	1	0	26	1	0.038461538461538464
4940	1507	32	1	0	33	1	0.030303030303030304
4941	1508	31	0	0	31	0	0
4942	1516	32	2	0	34	2	0.058823529411764705
4943	1526	32	1	0	33	1	0.030303030303030304
4944	1516	27	2	0	29	2	0.06896551724137931
4945	1530	28	1	0	29	1	0.034482758620689655
4946	1496	37	0	0	37	0	0
4947	1490	29	3	0	32	3	0.09375
4948	1498	29	0	0	29	0	0
4949	1513	35	0	0	35	0	0
495	1471	20	2	0	22	2	0.09090909090909091
4950	1497	29	2	0	31	2	0.06451612903225806
4951	1523	28	0	0	28	0	0
4952	1517	29	0	0	29	0	0
4953	1500	36	2	0	38	2	0.05263157894736842
4954	1510	31	1	0	32	1	0.03125
4955	1530	32	0	0	32	0	0
4956	1531	34	1	0	35	1	0.02857142857142857
4957	1496	27	2	0	29	2	0.06896551724137931
4958	1502	32	1	0	33	1	0.030303030303030304
4959	1523	21	2	0	23	2	0.08695652173913043
496	1488	30	0	0	30	0	0
4960	1523	36	1	0	37	1	0.02702702702702703
4961	1543	20	0	0	20	0	0
4962	1521	27	1	0	28	1	0.03571428571428571
4963	1526	25	1	0	26	1	0.038461538461538464
4964	1476	31	1	0	32	1	0.03125
4965	1465	31	0	0	31	0	0
4966	1521	24	3	0	27	3	0.1111111111111111
4967	1518	24	0	0	24	0	0
4968	1506	25	3	0	28	3	0.10714285714285714
4969	1482	29	0	0	29	0	0
497	1503	17	1	0	18	1	0.05555555555555555
4970	1514	33	0	0	33	0	0
4971	1510	37	2	0	39	2	0.05128205128205128
4972	1532	28	0	0	28	0	0
4973	1491	35	0	0	35	0	0
4974	1501	32	1	0	33	1	0.030303030303030304
4975	1532	25	0	0	25	0	0
4976	1484	38	1	0	39	1	0.02564102564102564
4977	1478	22	0	0	22	0	0
4978	1503	30	0	0	30	0	0
4979	1528	30	0	0	30	0	0
498	1513	23	0	0	23	0	0
4980	1522	30	2	0	32	2	0.0625
4981	1515	29	3	0	32	3	0.09375
4982	1529	26	0	0	26	0	0
4983	1504	35	0	0	35	0	0
4984	1506	27	0	0	27	0	0
4985	1504	21	2	0	23	2	0.08695652173913043
4986	1534	37	1	0	38	1	0.02631578947368421
4987	1461	30	0	0	30	0	0
4988	1494	27	2	0	29	2	0.06896551724137931
4989	1476	25	1	0	26	1	0.038461538461538464
499	1529	36	0	0	36	0	0
4990	1507	32	0	0	32	0	0
4991	1534	33	1	0	34	1	0.029411764705882353
4992	1520	35	1	1	37	2	0.05405405405405406
4993	1488	23	0	0	23	0	0
4994	1506	28	2	0	30	2	0.06666666666666667
4995	1486	37	2	0	39	2	0.05128205128205128
4996	1494	33	2	0	35	2	0.05714285714285714
4997	1495	28	4	0	32	4	0.125
4998	1516	29	1	0	30	1	0.03333333333333333
4999	1494	31	2	0	33	2	0.06060606060606061
5	1491	29	1	0	30	1	0.03333333333333333
50	1525	21	1	0	22	1	0.045454545454545456
500	1573	30	2	0	32	2	0.0625
5000	1489	32	1	0	33	1	0.030303030303030304
5001	1541	33	0	0	33	0	0
5002	1522	31	0	0	31	0	0
5003	1515	27	1	0	28	1	0.03571428571428571
5004	1493	24	2	0	26	2	0.07692307692307693
5005	1501	31	1	0	32	1	0.03125
5006	1534	28	1	0	29	1	0.034482758620689655
5007	1487	32	3	0	35	3	0.08571428571428572
5008	1531	36	1	0	37	1	0.02702702702702703
5009	1495	31	2	0	33	2	0.06060606060606061
501	1516	24	0	0	24	0	0
5010	1541	35	3	0	38	3	0.07894736842105263
5011	1499	26	1	0	27	1	0.037037037037037035
5012	1507	41	0	0	41	0	0
5013	1515	30	3	0	33	3	0.09090909090909091
5014	1475	30	3	0	33	3	0.09090909090909091
5015	1524	44	2	0	46	2	0.043478260869565216
5016	1475	28	1	0	29	1	0.034482758620689655
5017	1514	27	0	0	27	0	0
5018	1504	36	4	0	40	4	0.1
5019	1485	41	1	0	42	1	0.023809523809523808
502	1499	34	1	0	35	1	0.02857142857142857
5020	1519	24	1	0	25	1	0.04
5021	1531	36	1	0	37	1	0.02702702702702703
5022	1523	38	0	0	38	0	0
5023	1510	29	1	0	30	1	0.03333333333333333
5024	1523	35	0	0	35	0	0
5025	1484	25	1	0	26	1	0.038461538461538464
5026	1531	31	0	0	31	0	0
5027	1548	33	1	0	34	1	0.029411764705882353
5028	1506	25	1	0	26	1	0.038461538461538464
5029	1500	22	0	0	22	0	0
503	1472	25	0	0	25	0	0
5030	1512	40	1	0	41	1	0.024390243902439025
5031	1497	27	1	0	28	1	0.03571428571428571
5032	1502	28	1	0	29	1	0.034482758620689655
5033	1508	30	3	0	33	3	0.09090909090909091
5034	1503	33	1	0	34	1	0.029411764705882353
5035	1534	23	0	0	23	0	0
5036	1514	32	0	0	32	0	0
5037	1518	30	2	0	32	2	0.0625
5038	1516	33	0	0	33	0	0
5039	1490	26	1	0	27	1	0.037037037037037035
504	1513	27	2	0	29	2	0.06896551724137931
5040	1519	30	0	0	30	0	0
5041	1518	37	0	0	37	0	0
5042	1489	32	0	0	32	0	0
5043	1521	26	1	0	27	1	0.037037037037037035
5044	1489	36	1	0	37	1	0.02702702702702703
5045	1507	30	0	0	30	0	0
5046	1521	23	0	0	23	0	0
5047	1507	26	2	0	28	2	0.07142857142857142
5048	1518	41	2	0	43	2	0.046511627906976744
5049	1479	29	3	0	32	3	0.09375
505	1554	27	1	0	28	1	0.03571428571428571
5050	1512	36	1	0	37	1	0.02702702702702703
5051	1526	23	1	0	24	1	0.041666666666666664
5052	1488	38	0	0	38	0	0
5053	1509	38	1	0	39	1	0.02564102564102564
5054	1484	36	0	0	36	0	0
5055	1532	35	1	0	36	1	0.027777777777777776
5056	1508	28	0	0	28	0	0
5057	1530	32	0	0	32	0	0
5058	1529	31	1	0	32	1	0.03125
5059	1526	24	0	0	24	0	0
506	1518	29	0	0	29	0	0
5060	1473	30	1	0	31	1	0.03225806451612903
5061	1521	38	1	0	39	1	0.02564102564102564
5062	1501	39	1	0	40	1	0.025
5063	1527	28	1	0	29	1	0.034482758620689655
5064	1534	30	0	0	30	0	0
5065	1513	38	0	0	38	0	0
5066	1493	34	0	0	34	0	0
5067	1511	28	0	0	28	0	0
5068	1517	23	0	0	23	0	0
5069	1499	36	1	0	37	1	0.02702702702702703
507	1516	35	0	0	35	0	0
5070	1516	31	0	0	31	0	0
5071	1505	21	0	0	21	0	0
5072	1527	38	1	0	39	1	0.02564102564102564
5073	1479	39	1	0	40	1	0.025
5074	1498	30	0	0	30	0	0
5075	1519	31	1	0	32	1	0.03125
5076	1532	24	0	0	24	0	0
5077	1523	28	2	0	30	2	0.06666666666666667
5078	1499	27	0	0	27	0	0
5079	1511	29	1	0	30	1	0.03333333333333333
508	1488	31	2	0	33	2	0.06060606060606061
5080	1484	29	1	0	30	1	0.03333333333333333
5081	1514	40	0	0	40	0	0
5082	1516	24	1	0	25	1	0.04
5083	1468	25	0	0	25	0	0
5084	1538	26	2	0	28	2	0.07142857142857142
5085	1500	19	3	0	22	3	0.13636363636363635
5086	1519	26	1	0	27	1	0.037037037037037035
5087	1515	26	0	0	26	0	0
5088	1495	30	0	0	30	0	0
5089	1493	25	3	0	28	3	0.10714285714285714
509	1521	35	2	0	37	2	0.05405405405405406
5090	1485	34	3	0	37	3	0.08108108108108109
5091	1517	45	3	0	48	3	0.0625
5092	1502	35	1	0	36	1	0.027777777777777776
5093	1524	28	2	0	30	2	0.06666666666666667
5094	1488	33	1	0	34	1	0.029411764705882353
5095	1491	28	0	0	28	0	0
5096	1520	22	0	0	22	0	0
5097	1523	21	2	0	23	2	0.08695652173913043
5098	1539	24	0	0	24	0	0
5099	1505	21	0	0	21	0	0
51	1490	36	0	0	36	0	0
510	1533	19	2	0	21	2	0.09523809523809523
5100	1499	34	0	0	34	0	0
5101	1532	29	0	0	29	0	0
5102	1518	35	0	0	35	0	0
5103	1530	37	1	0	38	1	0.02631578947368421
5104	1507	21	1	0	22	1	0.045454545454545456
5105	1536	25	3	0	28	3	0.10714285714285714
5106	1518	21	3	0	24	3	0.125
5107	1505	32	1	0	33	1	0.030303030303030304
5108	1528	25	0	0	25	0	0
5109	1507	34	0	0	34	0	0
511	1511	40	1	0	41	1	0.024390243902439025
5110	1519	30	1	0	31	1	0.03225806451612903
5111	1532	33	0	0	33	0	0
5112	1516	38	1	0	39	1	0.02564102564102564
5113	1511	29	2	0	31	2	0.06451612903225806
5114	1531	22	0	0	22	0	0
5115	1514	36	0	0	36	0	0
5116	1520	33	2	0	35	2	0.05714285714285714
5117	1558	20	2	0	22	2	0.09090909090909091
5118	1524	25	1	0	26	1	0.038461538461538464
5119	1497	37	0	0	37	0	0
512	1522	30	2	0	32	2	0.0625
5120	1523	33	2	0	35	2	0.05714285714285714
5121	1542	19	1	0	20	1	0.05
5122	1528	29	1	0	30	1	0.03333333333333333
5123	1511	30	0	0	30	0	0
5124	1519	20	2	0	22	2	0.09090909090909091
5125	1506	26	2	0	28	2	0.07142857142857142
5126	1510	36	0	0	36	0	0
5127	1489	32	2	0	34	2	0.058823529411764705
5128	1514	26	0	0	26	0	0
5129	1531	23	0	0	23	0	0
513	1495	31	1	0	32	1	0.03125
5130	1487	24	1	0	25	1	0.04
5131	1516	33	2	0	35	2	0.05714285714285714
5132	1526	32	1	0	33	1	0.030303030303030304
5133	1481	29	0	0	29	0	0
5134	1513	30	0	0	30	0	0
5135	1524	32	0	0	32	0	0
5136	1521	35	3	0	38	3	0.07894736842105263
5137	1523	31	1	0	32	1	0.03125
5138	1489	36	1	0	37	1	0.02702702702702703
5139	1508	28	0	0	28	0	0
514	1521	25	1	0	26	1	0.038461538461538464
5140	1528	31	0	0	31	0	0
5141	1511	29	1	0	30	1	0.03333333333333333
5142	1510	28	0	0	28	0	0
5143	1491	35	3	0	38	3	0.07894736842105263
5144	1475	24	3	0	27	3	0.1111111111111111
5145	1487	35	0	0	35	0	0
5146	1491	30	3	0	33	3	0.09090909090909091
5147	1498	33	2	1	36	3	0.08333333333333333
5148	1549	28	0	0	28	0	0
5149	1530	28	1	0	29	1	0.034482758620689655
515	1507	33	1	0	34	1	0.029411764705882353
5150	1547	31	2	0	33	2	0.06060606060606061
5151	1519	26	0	0	26	0	0
5152	1514	33	0	0	33	0	0
5153	1496	37	0	0	37	0	0
5154	1513	18	1	0	19	1	0.05263157894736842
5155	1504	36	0	0	36	0	0
5156	1468	27	1	0	28	1	0.03571428571428571
5157	1495	28	0	0	28	0	0
5158	1529	38	1	0	39	1	0.02564102564102564
5159	1491	38	0	0	38	0	0
516	1525	41	1	0	42	1	0.023809523809523808
5160	1495	27	2	0	29	2	0.06896551724137931
5161	1472	37	1	0	38	1	0.02631578947368421
5162	1512	27	0	0	27	0	0
5163	1515	27	1	0	28	1	0.03571428571428571
5164	1513	29	3	0	32	3	0.09375
5165	1528	24	1	0	25	1	0.04
5166	1525	31	0	0	31	0	0
5167	1502	31	1	0	32	1	0.03125
5168	1507	37	2	0	39	2	0.05128205128205128
5169	1508	38	0	0	38	0	0
517	1533	31	1	0	32	1	0.03125
5170	1478	32	1	0	33	1	0.030303030303030304
5171	1502	30	0	0	30	0	0
5172	1509	29	1	0	30	1	0.03333333333333333
5173	1511	41	0	0	41	0	0
5174	1504	29	0	0	29	0	0
5175	1502	28	0	0	28	0	0
5176	1531	34	1	0	35	1	0.02857142857142857
5177	1499	34	1	0	35	1	0.02857142857142857
5178	1540	38	0	0	38	0	0
5179	1502	30	0	0	30	0	0
518	1482	27	0	0	27	0	0
5180	1519	24	1	0	25	1	0.04
5181	1519	35	0	0	35	0	0
5182	1518	26	1	0	27	1	0.037037037037037035
5183	1499	33	0	0	33	0	0
5184	1528	28	2	0	30	2	0.06666666666666667
5185	1505	28	2	0	30	2	0.06666666666666667
5186	1503	28	1	0	29	1	0.034482758620689655
5187	1504	33	0	0	33	0	0
5188	1512	25	0	0	25	0	0
5189	1523	35	2	0	37	2	0.05405405405405406
519	1544	30	0	0	30	0	0
5190	1511	20	1	0	21	1	0.047619047619047616
5191	1480	25	1	0	26	1	0.038461538461538464
5192	1505	29	0	0	29	0	0
5193	1488	29	1	0	30	1	0.03333333333333333
5194	1518	32	0	0	32	0	0
5195	1477	45	1	0	46	1	0.021739130434782608
5196	1516	41	1	0	42	1	0.023809523809523808
5197	1485	30	1	0	31	1	0.03225806451612903
5198	1511	25	0	0	25	0	0
5199	1515	21	0	0	21	0	0
52	1528	24	1	0	25	1	0.04
520	1522	35	0	0	35	0	0
5200	1535	22	1	0	23	1	0.043478260869565216
5201	1471	26	0	0	26	0	0
5202	1522	28	0	0	28	0	0
5203	1502	34	1	0	35	1	0.02857142857142857
5204	1518	23	0	0	23	0	0
5205	1504	32	3	0	35	3	0.08571428571428572
5206	1497	38	0	0	38	0	0
5207	1513	32	0	0	32	0	0
5208	1495	36	2	0	38	2	0.05263157894736842
5209	1482	26	0	0	26	0	0
521	1466	42	1	0	43	1	0.023255813953488372
5210	1476	32	0	0	32	0	0
5211	1513	38	0	0	38	0	0
5212	1512	32	0	0	32	0	0
5213	1495	38	1	0	39	1	0.02564102564102564
5214	1550	33	1	0	34	1	0.029411764705882353
5215	1521	30	3	0	33	3	0.09090909090909091
5216	1506	33	1	0	34	1	0.029411764705882353
5217	1498	24	0	0	24	0	0
5218	1498	37	3	0	40	3	0.075
5219	1485	39	1	0	40	1	0.025
522	1544	24	1	0	25	1	0.04
5220	1521	27	1	0	28	1	0.03571428571428571
5221	1511	36	1	0	37	1	0.02702702702702703
5222	1486	34	2	0	36	2	0.05555555555555555
5223	1518	25	1	0	26	1	0.038461538461538464
5224	1519	30	0	0	30	0	0
5225	1534	35	0	0	35	0	0
5226	1486	35	0	0	35	0	0
5227	1509	23	1	0	24	1	0.041666666666666664
5228	1498	28	3	0	31	3	0.0967741935483871
5229	1488	34	1	0	35	1	0.02857142857142857
523	1537	25	1	0	26	1	0.038461538461538464
5230	1483	27	0	0	27	0	0
5231	1517	26	1	0	27	1	0.037037037037037035
5232	1524	28	0	0	28	0	0
5233	1516	33	1	0	34	1	0.029411764705882353
5234	1493	17	2	0	19	2	0.10526315789473684
5235	1485	26	0	0	26	0	0
5236	1488	31	2	0	33	2	0.06060606060606061
5237	1532	26	3	0	29	3	0.10344827586206896
5238	1504	36	0	0	36	0	0
5239	1466	29	1	0	30	1	0.03333333333333333
524	1526	26	0	0	26	0	0
5240	1501	46	1	0	47	1	0.02127659574468085
5241	1526	31	0	0	31	0	0
5242	1508	38	2	0	40	2	0.05
5243	1494	35	0	0	35	0	0
5244	1534	29	0	0	29	0	0
5245	1510	26	1	0	27	1	0.037037037037037035
5246	1525	30	2	0	32	2	0.0625
5247	1521	27	0	0	27	0	0
5248	1505	18	0	0	18	0	0
5249	1541	23	0	0	23	0	0
525	1539	29	1	0	30	1	0.03333333333333333
5250	1528	23	0	0	23	0	0
5251	1519	41	1	0	42	1	0.023809523809523808
5252	1479	29	2	0	31	2	0.06451612903225806
5253	1534	36	1	0	37	1	0.02702702702702703
5254	1505	23	3	0	26	3	0.11538461538461539
5255	1466	23	0	0	23	0	0
5256	1497	25	0	0	25	0	0
5257	1536	30	2	0	32	2	0.0625
5258	1476	36	1	0	37	1	0.02702702702702703
5259	1496	26	1	0	27	1	0.037037037037037035
526	1494	24	2	0	26	2	0.07692307692307693
5260	1568	38	0	0	38	0	0
5261	1507	24	0	0	24	0	0
5262	1536	33	1	0	34	1	0.029411764705882353
5263	1513	26	3	0	29	3	0.10344827586206896
5264	1547	34	1	0	35	1	0.02857142857142857
5265	1518	32	1	0	33	1	0.030303030303030304
5266	1495	29	0	0	29	0	0
5267	1519	32	2	0	34	2	0.058823529411764705
5268	1531	31	0	0	31	0	0
5269	1508	31	0	0	31	0	0
527	1504	29	1	0	30	1	0.03333333333333333
5270	1516	30	0	0	30	0	0
5271	1519	29	2	0	31	2	0.06451612903225806
5272	1524	20	1	0	21	1	0.047619047619047616
5273	1513	35	0	0	35	0	0
5274	1530	38	0	0	38	0	0
5275	1520	26	0	0	26	0	0
5276	1492	33	0	0	33	0	0
5277	1527	31	1	0	32	1	0.03125
5278	1511	32	1	0	33	1	0.030303030303030304
5279	1527	39	4	0	43	4	0.09302325581395349
528	1528	34	0	0	34	0	0
5280	1505	20	2	0	22	2	0.09090909090909091
5281	1531	26	0	0	26	0	0
5282	1507	35	1	0	36	1	0.027777777777777776
5283	1501	25	1	0	26	1	0.038461538461538464
5284	1525	38	1	0	39	1	0.02564102564102564
5285	1522	19	0	0	19	0	0
5286	1519	31	2	0	33	2	0.06060606060606061
5287	1513	34	1	0	35	1	0.02857142857142857
5288	1500	36	0	0	36	0	0
5289	1527	30	1	0	31	1	0.03225806451612903
529	1477	28	1	0	29	1	0.034482758620689655
5290	1532	32	1	0	33	1	0.030303030303030304
5291	1522	33	0	0	33	0	0
5292	1507	31	4	0	35	4	0.11428571428571428
5293	1507	29	0	0	29	0	0
5294	1543	29	1	0	30	1	0.03333333333333333
5295	1501	35	0	0	35	0	0
5296	1517	25	1	0	26	1	0.038461538461538464
5297	1500	29	2	0	31	2	0.06451612903225806
5298	1532	37	1	0	38	1	0.02631578947368421
5299	1508	28	1	0	29	1	0.034482758620689655
53	1500	25	0	0	25	0	0
530	1501	28	1	0	29	1	0.034482758620689655
5300	1528	37	3	0	40	3	0.075
5301	1496	31	1	0	32	1	0.03125
5302	1534	31	1	0	32	1	0.03125
5303	1491	31	3	0	34	3	0.08823529411764706
5304	1486	47	0	0	47	0	0
5305	1510	34	1	0	35	1	0.02857142857142857
5306	1521	38	1	0	39	1	0.02564102564102564
5307	1530	39	0	0	39	0	0
5308	1556	29	1	0	30	1	0.03333333333333333
5309	1493	23	0	0	23	0	0
531	1491	28	0	0	28	0	0
5310	1503	31	2	0	33	2	0.06060606060606061
5311	1518	23	0	0	23	0	0
5312	1509	32	1	0	33	1	0.030303030303030304
5313	1484	28	3	0	31	3	0.0967741935483871
5314	1536	33	2	0	35	2	0.05714285714285714
5315	1521	28	2	0	30	2	0.06666666666666667
5316	1529	30	1	0	31	1	0.03225806451612903
5317	1528	41	3	0	44	3	0.06818181818181818
5318	1488	21	0	0	21	0	0
5319	1497	33	1	0	34	1	0.029411764705882353
532	1517	31	0	0	31	0	0
5320	1481	37	1	0	38	1	0.02631578947368421
5321	1516	31	1	0	32	1	0.03125
5322	1491	31	0	0	31	0	0
5323	1544	25	0	0	25	0	0
5324	1456	25	0	0	25	0	0
5325	1536	32	0	0	32	0	0
5326	1500	24	0	0	24	0	0
5327	1486	32	2	0	34	2	0.058823529411764705
5328	1520	24	0	0	24	0	0
5329	1506	25	0	0	25	0	0
533	1540	30	1	0	31	1	0.03225806451612903
5330	1515	28	1	0	29	1	0.034482758620689655
5331	1536	34	0	0	34	0	0
5332	1521	31	1	0	32	1	0.03125
5333	1498	27	1	0	28	1	0.03571428571428571
5334	1511	32	0	0	32	0	0
5335	1491	35	4	0	39	4	0.10256410256410256
5336	1532	39	1	0	40	1	0.025
5337	1526	35	0	0	35	0	0
5338	1489	30	0	0	30	0	0
5339	1497	24	0	0	24	0	0
534	1544	32	3	0	35	3	0.08571428571428572
5340	1510	31	3	0	34	3	0.08823529411764706
5341	1539	30	2	0	32	2	0.0625
5342	1509	37	1	0	38	1	0.02631578947368421
5343	1501	34	1	0	35	1	0.02857142857142857
5344	1486	35	2	0	37	2	0.05405405405405406
5345	1492	30	1	0	31	1	0.03225806451612903
5346	1483	31	0	0	31	0	0
5347	1533	26	2	0	28	2	0.07142857142857142
5348	1509	28	1	0	29	1	0.034482758620689655
5349	1526	31	2	0	33	2	0.06060606060606061
535	1533	25	1	0	26	1	0.038461538461538464
5350	1530	20	3	0	23	3	0.13043478260869565
5351	1503	32	0	0	32	0	0
5352	1514	36	0	0	36	0	0
5353	1519	36	1	0	37	1	0.02702702702702703
5354	1526	25	2	0	27	2	0.07407407407407407
5355	1521	36	0	0	36	0	0
5356	1491	30	2	0	32	2	0.0625
5357	1501	31	0	0	31	0	0
5358	1495	30	0	0	30	0	0
5359	1496	26	3	0	29	3	0.10344827586206896
536	1492	23	2	0	25	2	0.08
5360	1496	23	3	0	26	3	0.11538461538461539
5361	1513	20	2	0	22	2	0.09090909090909091
5362	1501	37	1	0	38	1	0.02631578947368421
5363	1532	26	0	0	26	0	0
5364	1503	26	0	0	26	0	0
5365	1490	31	3	0	34	3	0.08823529411764706
5366	1519	23	1	0	24	1	0.041666666666666664
5367	1520	37	2	0	39	2	0.05128205128205128
5368	1540	29	0	0	29	0	0
5369	1536	30	1	0	31	1	0.03225806451612903
537	1522	28	1	0	29	1	0.034482758620689655
5370	1531	37	1	0	38	1	0.02631578947368421
5371	1525	31	0	0	31	0	0
5372	1488	31	0	0	31	0	0
5373	1514	30	0	0	30	0	0
5374	1541	26	2	0	28	2	0.07142857142857142
5375	1490	22	2	0	24	2	0.08333333333333333
5376	1538	29	0	0	29	0	0
5377	1529	27	1	0	28	1	0.03571428571428571
5378	1530	21	1	0	22	1	0.045454545454545456
5379	1549	39	0	0	39	0	0
538	1507	23	1	0	24	1	0.041666666666666664
5380	1510	32	0	0	32	0	0
5381	1500	21	1	0	22	1	0.045454545454545456
5382	1500	19	1	0	20	1	0.05
5383	1516	42	0	0	42	0	0
5384	1493	29	0	0	29	0	0
5385	1483	37	1	0	38	1	0.02631578947368421
5386	1482	25	1	0	26	1	0.038461538461538464
5387	1500	42	0	0	42	0	0
5388	1503	40	3	0	43	3	0.06976744186046512
5389	1521	33	0	0	33	0	0
539	1480	26	0	0	26	0	0
5390	1513	38	1	0	39	1	0.02564102564102564
5391	1536	30	3	0	33	3	0.09090909090909091
5392	1528	32	2	0	34	2	0.058823529411764705
5393	1517	34	0	0	34	0	0
5394	1480	40	0	0	40	0	0
5395	1495	31	0	0	31	0	0
5396	1506	21	1	0	22	1	0.045454545454545456
5397	1529	33	2	0	35	2	0.05714285714285714
5398	1517	19	1	0	20	1	0.05
5399	1506	37	1	0	38	1	0.02631578947368421
54	1503	31	1	0	32	1	0.03125
540	1502	36	1	0	37	1	0.02702702702702703
5400	1535	29	1	0	30	1	0.03333333333333333
5401	1498	22	0	0	22	0	0
5402	1535	31	1	0	32	1	0.03125
5403	1504	25	1	0	26	1	0.038461538461538464
5404	1557	25	4	0	29	4	0.13793103448275862
5405	1525	28	2	0	30	2	0.06666666666666667
5406	1463	32	0	0	32	0	0
5407	1509	28	0	0	28	0	0
5408	1517	27	0	0	27	0	0
5409	1469	40	1	0	41	1	0.024390243902439025
541	1505	32	4	0	36	4	0.1111111111111111
5410	1501	33	1	0	34	1	0.029411764705882353
5411	1528	31	0	0	31	0	0
5412	1528	27	0	0	27	0	0
5413	1539	27	0	0	27	0	0
5414	1517	37	0	0	37	0	0
5415	1489	23	1	0	24	1	0.041666666666666664
5416	1500	32	1	0	33	1	0.030303030303030304
5417	1515	19	2	1	22	3	0.13636363636363635
5418	1545	24	0	0	24	0	0
5419	1498	36	2	0	38	2	0.05263157894736842
542	1499	36	0	0	36	0	0
5420	1534	30	1	0	31	1	0.03225806451612903
5421	1508	33	0	0	33	0	0
5422	1515	40	1	0	41	1	0.024390243902439025
5423	1514	30	2	0	32	2	0.0625
5424	1516	31	3	0	34	3	0.08823529411764706
5425	1520	31	0	0	31	0	0
5426	1489	40	0	0	40	0	0
5427	1501	28	1	0	29	1	0.034482758620689655
5428	1535	29	0	0	29	0	0
5429	1491	27	2	0	29	2	0.06896551724137931
543	1491	30	1	0	31	1	0.03225806451612903
5430	1497	24	1	0	25	1	0.04
5431	1497	29	0	0	29	0	0
5432	1485	26	1	0	27	1	0.037037037037037035
5433	1497	41	0	0	41	0	0
5434	1495	33	1	0	34	1	0.029411764705882353
5435	1492	30	0	0	30	0	0
5436	1496	34	0	0	34	0	0
5437	1522	43	1	0	44	1	0.022727272727272728
5438	1487	27	0	1	28	1	0.03571428571428571
5439	1546	35	3	0	38	3	0.07894736842105263
544	1477	37	0	0	37	0	0
5440	1501	26	1	0	27	1	0.037037037037037035
5441	1511	25	1	0	26	1	0.038461538461538464
5442	1518	23	1	0	24	1	0.041666666666666664
5443	1532	30	1	0	31	1	0.03225806451612903
5444	1494	33	0	0	33	0	0
5445	1522	33	3	0	36	3	0.08333333333333333
5446	1518	26	0	0	26	0	0
5447	1489	30	1	0	31	1	0.03225806451612903
5448	1526	29	1	0	30	1	0.03333333333333333
5449	1511	29	0	0	29	0	0
545	1485	26	0	0	26	0	0
5450	1502	33	1	0	34	1	0.029411764705882353
5451	1528	22	2	0	24	2	0.08333333333333333
5452	1525	25	0	0	25	0	0
5453	1539	25	1	0	26	1	0.038461538461538464
5454	1511	20	3	0	23	3	0.13043478260869565
5455	1496	33	2	0	35	2	0.05714285714285714
5456	1527	26	1	0	27	1	0.037037037037037035
5457	1512	25	2	0	27	2	0.07407407407407407
5458	1559	34	1	0	35	1	0.02857142857142857
5459	1495	26	1	0	27	1	0.037037037037037035
546	1502	29	1	0	30	1	0.03333333333333333
5460	1481	28	0	0	28	0	0
5461	1504	34	0	0	34	0	0
5462	1489	28	1	0	29	1	0.034482758620689655
5463	1519	23	0	0	23	0	0
5464	1482	37	1	0	38	1	0.02631578947368421
5465	1515	21	0	0	21	0	0
5466	1485	29	0	0	29	0	0
5467	1523	32	1	0	33	1	0.030303030303030304
5468	1502	29	0	0	29	0	0
5469	1498	29	0	0	29	0	0
547	1503	21	1	0	22	1	0.045454545454545456
5470	1497	29	1	0	30	1	0.03333333333333333
5471	1507	32	1	0	33	1	0.030303030303030304
5472	1505	27	2	0	29	2	0.06896551724137931
5473	1514	31	1	0	32	1	0.03125
5474	1475	27	0	0	27	0	0
5475	1482	34	2	0	36	2	0.05555555555555555
5476	1501	28	0	0	28	0	0
5477	1492	38	2	0	40	2	0.05
5478	1526	24	0	0	24	0	0
5479	1507	31	2	0	33	2	0.06060606060606061
548	1493	25	0	0	25	0	0
5480	1541	29	0	0	29	0	0
5481	1495	32	0	0	32	0	0
5482	1504	33	3	0	36	3	0.08333333333333333
5483	1535	34	0	0	34	0	0
5484	1515	46	1	0	47	1	0.02127659574468085
5485	1528	31	1	0	32	1	0.03125
5486	1513	34	3	0	37	3	0.08108108108108109
5487	1475	31	1	0	32	1	0.03125
5488	1494	37	2	0	39	2	0.05128205128205128
5489	1523	25	0	0	25	0	0
549	1552	37	2	0	39	2	0.05128205128205128
5490	1528	36	2	0	38	2	0.05263157894736842
5491	1478	33	0	0	33	0	0
5492	1503	24	0	0	24	0	0
5493	1515	28	3	1	32	4	0.125
5494	1493	34	2	0	36	2	0.05555555555555555
5495	1511	27	1	0	28	1	0.03571428571428571
5496	1509	24	1	0	25	1	0.04
5497	1482	47	2	0	49	2	0.04081632653061224
5498	1517	26	2	0	28	2	0.07142857142857142
5499	1505	42	1	0	43	1	0.023255813953488372
55	1521	34	0	0	34	0	0
550	1511	34	0	0	34	0	0
5500	1524	35	2	0	37	2	0.05405405405405406
5501	1495	24	1	0	25	1	0.04
5502	1539	29	1	1	31	2	0.06451612903225806
5503	1474	31	1	0	32	1	0.03125
5504	1531	31	0	0	31	0	0
5505	1508	36	0	0	36	0	0
5506	1539	26	1	0	27	1	0.037037037037037035
5507	1505	25	1	0	26	1	0.038461538461538464
5508	1495	33	1	0	34	1	0.029411764705882353
5509	1500	30	0	0	30	0	0
551	1550	36	1	0	37	1	0.02702702702702703
5510	1502	27	0	0	27	0	0
5511	1516	34	1	0	35	1	0.02857142857142857
5512	1524	32	1	0	33	1	0.030303030303030304
5513	1488	29	1	0	30	1	0.03333333333333333
5514	1525	29	1	0	30	1	0.03333333333333333
5515	1518	37	1	0	38	1	0.02631578947368421
5516	1555	23	0	0	23	0	0
5517	1507	31	1	0	32	1	0.03125
5518	1503	33	1	0	34	1	0.029411764705882353
5519	1467	27	1	0	28	1	0.03571428571428571
552	1530	30	0	0	30	0	0
5520	1486	39	0	0	39	0	0
5521	1510	33	0	0	33	0	0
5522	1521	29	0	0	29	0	0
5523	1503	34	1	0	35	1	0.02857142857142857
5524	1463	32	0	0	32	0	0
5525	1499	22	0	0	22	0	0
5526	1539	20	2	0	22	2	0.09090909090909091
5527	1531	22	1	0	23	1	0.043478260869565216
5528	1524	35	2	0	37	2	0.05405405405405406
5529	1537	40	1	0	41	1	0.024390243902439025
553	1506	32	1	0	33	1	0.030303030303030304
5530	1490	30	0	0	30	0	0
5531	1472	26	1	0	27	1	0.037037037037037035
5532	1496	28	1	0	29	1	0.034482758620689655
5533	1493	28	0	0	28	0	0
5534	1527	24	1	0	25	1	0.04
5535	1511	35	0	0	35	0	0
5536	1472	28	0	0	28	0	0
5537	1530	30	1	0	31	1	0.03225806451612903
5538	1527	34	0	0	34	0	0
5539	1513	26	2	0	28	2	0.07142857142857142
554	1543	25	1	0	26	1	0.038461538461538464
5540	1499	28	1	0	29	1	0.034482758620689655
5541	1496	20	0	0	20	0	0
5542	1491	22	1	0	23	1	0.043478260869565216
5543	1525	32	1	0	33	1	0.030303030303030304
5544	1476	32	0	0	32	0	0
5545	1547	34	1	0	35	1	0.02857142857142857
5546	1527	29	1	0	30	1	0.03333333333333333
5547	1532	23	4	0	27	4	0.14814814814814814
5548	1552	26	2	0	28	2	0.07142857142857142
5549	1515	24	1	0	25	1	0.04
555	1469	27	2	0	29	2	0.06896551724137931
5550	1527	37	2	0	39	2	0.05128205128205128
5551	1515	26	1	0	27	1	0.037037037037037035
5552	1511	26	1	0	27	1	0.037037037037037035
5553	1505	40	0	0	40	0	0
5554	1522	31	0	0	31	0	0
5555	1554	33	1	0	34	1	0.029411764705882353
5556	1539	32	0	0	32	0	0
5557	1496	30	0	0	30	0	0
5558	1490	40	0	0	40	0	0
5559	1520	42	0	0	42	0	0
556	1523	34	0	0	34	0	0
5560	1528	28	2	0	30	2	0.06666666666666667
5561	1537	29	0	0	29	0	0
5562	1491	29	3	0	32	3	0.09375
5563	1547	18	0	0	18	0	0
5564	1527	29	0	0	29	0	0
5565	1489	27	1	0	28	1	0.03571428571428571
5566	1547	36	1	0	37	1	0.02702702702702703
5567	1501	28	1	0	29	1	0.034482758620689655
5568	1529	39	4	0	43	4	0.09302325581395349
5569	1517	28	0	0	28	0	0
557	1531	29	1	0	30	1	0.03333333333333333
5570	1488	32	2	0	34	2	0.058823529411764705
5571	1538	31	2	0	33	2	0.06060606060606061
5572	1488	28	0	0	28	0	0
5573	1494	32	0	0	32	0	0
5574	1545	29	0	0	29	0	0
5575	1534	25	0	0	25	0	0
5576	1520	27	0	0	27	0	0
5577	1523	27	0	0	27	0	0
5578	1542	29	3	0	32	3	0.09375
5579	1527	24	1	0	25	1	0.04
558	1498	34	3	0	37	3	0.08108108108108109
5580	1540	33	0	0	33	0	0
5581	1476	31	2	0	33	2	0.06060606060606061
5582	1486	21	1	0	22	1	0.045454545454545456
5583	1541	27	1	0	28	1	0.03571428571428571
5584	1544	31	1	0	32	1	0.03125
5585	1502	45	1	0	46	1	0.021739130434782608
5586	1507	31	0	0	31	0	0
5587	1483	34	2	0	36	2	0.05555555555555555
5588	1508	30	0	0	30	0	0
5589	1518	31	1	0	32	1	0.03125
559	1528	34	1	0	35	1	0.02857142857142857
5590	1529	27	0	0	27	0	0
5591	1514	32	0	0	32	0	0
5592	1505	21	0	0	21	0	0
5593	1514	37	1	0	38	1	0.02631578947368421
5594	1486	32	0	0	32	0	0
5595	1530	27	1	0	28	1	0.03571428571428571
5596	1485	38	1	0	39	1	0.02564102564102564
5597	1547	31	0	0	31	0	0
5598	1486	33	0	0	33	0	0
5599	1513	24	0	0	24	0	0
56	1481	35	1	0	36	1	0.027777777777777776
560	1504	36	1	0	37	1	0.02702702702702703
5600	1512	24	0	0	24	0	0
5601	1491	33	0	0	33	0	0
5602	1531	31	1	0	32	1	0.03125
5603	1516	32	1	0	33	1	0.030303030303030304
5604	1514	37	0	0	37	0	0
5605	1490	25	0	0	25	0	0
5606	1502	22	0	0	22	0	0
5607	1541	36	2	0	38	2	0.05263157894736842
5608	1517	31	1	0	32	1	0.03125
5609	1523	31	0	0	31	0	0
561	1522	31	0	0	31	0	0
5610	1478	26	0	0	26	0	0
5611	1523	31	0	0	31	0	0
5612	1505	28	0	0	28	0	0
5613	1537	37	0	0	37	0	0
5614	1546	23	2	0	25	2	0.08
5615	1502	28	0	0	28	0	0
5616	1524	30	1	0	31	1	0.03225806451612903
5617	1509	24	0	1	25	1	0.04
5618	1509	38	1	0	39	1	0.02564102564102564
5619	1496	30	0	0	30	0	0
562	1528	33	1	0	34	1	0.029411764705882353
5620	1542	21	1	0	22	1	0.045454545454545456
5621	1475	29	0	0	29	0	0
5622	1523	34	1	0	35	1	0.02857142857142857
5623	1514	37	2	0	39	2	0.05128205128205128
5624	1531	31	0	0	31	0	0
5625	1489	27	0	0	27	0	0
5626	1506	32	0	0	32	0	0
5627	1515	36	2	0	38	2	0.05263157894736842
5628	1510	21	0	0	21	0	0
5629	1524	25	3	0	28	3	0.10714285714285714
563	1489	38	1	0	39	1	0.02564102564102564
5630	1513	25	0	0	25	0	0
5631	1528	33	0	0	33	0	0
5632	1504	25	2	0	27	2	0.07407407407407407
5633	1487	39	0	0	39	0	0
5634	1468	27	2	0	29	2	0.06896551724137931
5635	1524	33	1	0	34	1	0.029411764705882353
5636	1529	23	1	0	24	1	0.041666666666666664
5637	1481	31	2	0	33	2	0.06060606060606061
5638	1537	29	1	0	30	1	0.03333333333333333
5639	1501	38	0	0	38	0	0
564	1518	25	3	0	28	3	0.10714285714285714
5640	1498	36	1	0	37	1	0.02702702702702703
5641	1513	33	1	0	34	1	0.029411764705882353
5642	1510	34	3	0	37	3	0.08108108108108109
5643	1520	28	1	0	29	1	0.034482758620689655
5644	1484	29	1	0	30	1	0.03333333333333333
5645	1509	34	2	0	36	2	0.05555555555555555
5646	1517	38	0	0	38	0	0
5647	1510	40	1	0	41	1	0.024390243902439025
5648	1481	28	0	0	28	0	0
5649	1492	37	1	0	38	1	0.02631578947368421
565	1491	28	1	0	29	1	0.034482758620689655
5650	1536	26	1	0	27	1	0.037037037037037035
5651	1545	34	2	0	36	2	0.05555555555555555
5652	1502	27	0	0	27	0	0
5653	1518	19	2	0	21	2	0.09523809523809523
5654	1477	37	0	0	37	0	0
5655	1539	24	1	0	25	1	0.04
5656	1519	37	1	0	38	1	0.02631578947368421
5657	1500	18	1	0	19	1	0.05263157894736842
5658	1502	34	0	0	34	0	0
5659	1504	29	1	0	30	1	0.03333333333333333
566	1508	28	0	0	28	0	0
5660	1495	37	1	0	38	1	0.02631578947368421
5661	1534	33	1	0	34	1	0.029411764705882353
5662	1494	27	1	0	28	1	0.03571428571428571
5663	1501	29	1	0	30	1	0.03333333333333333
5664	1534	27	0	0	27	0	0
5665	1540	35	0	0	35	0	0
5666	1521	34	0	0	34	0	0
5667	1491	25	3	0	28	3	0.10714285714285714
5668	1504	34	2	0	36	2	0.05555555555555555
5669	1496	26	0	0	26	0	0
567	1520	24	1	0	25	1	0.04
5670	1476	42	1	0	43	1	0.023255813953488372
5671	1517	30	2	0	32	2	0.0625
5672	1508	33	0	0	33	0	0
5673	1516	31	0	0	31	0	0
5674	1536	18	1	0	19	1	0.05263157894736842
5675	1514	25	1	0	26	1	0.038461538461538464
5676	1510	37	1	0	38	1	0.02631578947368421
5677	1535	22	1	0	23	1	0.043478260869565216
5678	1498	24	0	0	24	0	0
5679	1540	34	1	0	35	1	0.02857142857142857
568	1522	34	0	0	34	0	0
5680	1524	29	0	0	29	0	0
5681	1535	33	0	0	33	0	0
5682	1536	30	1	0	31	1	0.03225806451612903
5683	1502	32	1	0	33	1	0.030303030303030304
5684	1538	38	1	0	39	1	0.02564102564102564
5685	1525	21	0	0	21	0	0
5686	1507	32	0	0	32	0	0
5687	1489	32	2	0	34	2	0.058823529411764705
5688	1501	37	1	0	38	1	0.02631578947368421
5689	1503	32	0	0	32	0	0
569	1536	34	2	0	36	2	0.05555555555555555
5690	1487	41	0	0	41	0	0
5691	1514	27	2	0	29	2	0.06896551724137931
5692	1546	32	0	0	32	0	0
5693	1496	33	1	0	34	1	0.029411764705882353
5694	1532	32	1	0	33	1	0.030303030303030304
5695	1512	19	1	0	20	1	0.05
5696	1518	22	0	0	22	0	0
5697	1518	28	0	0	28	0	0
5698	1493	25	0	0	25	0	0
5699	1544	33	1	0	34	1	0.029411764705882353
57	1491	24	3	0	27	3	0.1111111111111111
570	1505	28	0	0	28	0	0
5700	1524	33	0	0	33	0	0
5701	1504	33	0	0	33	0	0
5702	1484	40	0	0	40	0	0
5703	1496	28	1	0	29	1	0.034482758620689655
5704	1534	32	0	0	32	0	0
5705	1489	25	1	0	26	1	0.038461538461538464
5706	1510	30	0	0	30	0	0
5707	1527	33	1	0	34	1	0.029411764705882353
5708	1490	25	2	0	27	2	0.07407407407407407
5709	1540	29	0	0	29	0	0
571	1515	25	3	0	28	3	0.10714285714285714
5710	1523	35	2	0	37	2	0.05405405405405406
5711	1515	27	1	0	28	1	0.03571428571428571
5712	1525	27	0	0	27	0	0
5713	1530	33	1	0	34	1	0.029411764705882353
5714	1547	37	1	0	38	1	0.02631578947368421
5715	1528	27	1	0	28	1	0.03571428571428571
5716	1538	41	0	0	41	0	0
5717	1487	30	0	0	30	0	0
5718	1504	29	1	0	30	1	0.03333333333333333
5719	1529	30	1	0	31	1	0.03225806451612903
572	1517	33	1	0	34	1	0.029411764705882353
5720	1525	43	2	0	45	2	0.044444444444444446
5721	1530	24	1	0	25	1	0.04
5722	1498	29	0	0	29	0	0
5723	1520	34	0	0	34	0	0
5724	1554	22	3	0	25	3	0.12
5725	1511	21	1	0	22	1	0.045454545454545456
5726	1522	32	0	0	32	0	0
5727	1502	39	1	0	40	1	0.025
5728	1492	32	0	0	32	0	0
5729	1525	33	1	0	34	1	0.029411764705882353
573	1493	33	1	0	34	1	0.029411764705882353
5730	1520	29	0	0	29	0	0
5731	1455	27	1	0	28	1	0.03571428571428571
5732	1493	27	0	0	27	0	0
5733	1526	28	0	0	28	0	0
5734	1550	25	3	0	28	3	0.10714285714285714
5735	1503	32	3	0	35	3	0.08571428571428572
5736	1519	24	1	0	25	1	0.04
5737	1516	24	1	0	25	1	0.04
5738	1507	23	2	0	25	2	0.08
5739	1524	27	1	0	28	1	0.03571428571428571
574	1516	34	1	0	35	1	0.02857142857142857
5740	1515	37	0	0	37	0	0
5741	1532	32	0	0	32	0	0
5742	1535	29	0	0	29	0	0
5743	1526	30	3	0	33	3	0.09090909090909091
5744	1482	28	1	0	29	1	0.034482758620689655
5745	1489	31	1	0	32	1	0.03125
5746	1489	25	0	0	25	0	0
5747	1479	31	0	0	31	0	0
5748	1488	39	0	0	39	0	0
5749	1494	32	1	0	33	1	0.030303030303030304
575	1509	28	0	0	28	0	0
5750	1499	33	1	0	34	1	0.029411764705882353
5751	1506	19	2	0	21	2	0.09523809523809523
5752	1515	22	0	0	22	0	0
5753	1497	29	1	0	30	1	0.03333333333333333
5754	1502	37	1	0	38	1	0.02631578947368421
5755	1537	24	0	0	24	0	0
5756	1482	40	1	0	41	1	0.024390243902439025
5757	1483	25	1	0	26	1	0.038461538461538464
5758	1535	28	1	0	29	1	0.034482758620689655
5759	1496	36	0	0	36	0	0
576	1527	26	0	0	26	0	0
5760	1512	32	0	0	32	0	0
5761	1481	27	0	0	27	0	0
5762	1516	36	2	0	38	2	0.05263157894736842
5763	1528	26	0	0	26	0	0
5764	1511	29	0	0	29	0	0
5765	1531	23	0	0	23	0	0
5766	1495	32	2	0	34	2	0.058823529411764705
5767	1520	35	0	0	35	0	0
5768	1510	31	2	0	33	2	0.06060606060606061
5769	1522	26	2	0	28	2	0.07142857142857142
577	1539	33	2	0	35	2	0.05714285714285714
5770	1546	30	0	0	30	0	0
5771	1493	39	0	0	39	0	0
5772	1529	36	0	0	36	0	0
5773	1542	24	1	0	25	1	0.04
5774	1516	13	0	0	13	0	0
5775	1506	22	2	0	24	2	0.08333333333333333
5776	1499	36	0	0	36	0	0
5777	1520	32	0	0	32	0	0
5778	1517	28	2	0	30	2	0.06666666666666667
5779	1534	30	1	0	31	1	0.03225806451612903
578	1496	28	1	0	29	1	0.034482758620689655
5780	1536	30	0	0	30	0	0
5781	1506	28	2	0	30	2	0.06666666666666667
5782	1528	29	1	0	30	1	0.03333333333333333
5783	1549	30	1	0	31	1	0.03225806451612903
5784	1499	33	1	0	34	1	0.029411764705882353
5785	1526	33	0	0	33	0	0
5786	1498	28	0	0	28	0	0
5787	1513	25	0	0	25	0	0
5788	1490	50	0	0	50	0	0
5789	1525	24	1	0	25	1	0.04
579	1500	25	0	0	25	0	0
5790	1512	27	1	0	28	1	0.03571428571428571
5791	1476	31	2	0	33	2	0.06060606060606061
5792	1510	30	1	0	31	1	0.03225806451612903
5793	1539	28	0	0	28	0	0
5794	1516	41	1	0	42	1	0.023809523809523808
5795	1522	32	1	0	33	1	0.030303030303030304
5796	1505	37	1	0	38	1	0.02631578947368421
5797	1532	36	1	0	37	1	0.02702702702702703
5798	1509	29	0	0	29	0	0
5799	1546	42	2	0	44	2	0.045454545454545456
58	1535	24	1	0	25	1	0.04
580	1527	36	0	0	36	0	0
5800	1537	25	0	0	25	0	0
5801	1497	41	3	0	44	3	0.06818181818181818
5802	1486	39	1	0	40	1	0.025
5803	1470	27	1	0	28	1	0.03571428571428571
5804	1527	22	2	0	24	2	0.08333333333333333
5805	1507	31	0	0	31	0	0
5806	1522	27	0	0	27	0	0
5807	1467	38	2	0	40	2	0.05
5808	1528	30	3	0	33	3	0.09090909090909091
5809	1514	28	1	0	29	1	0.034482758620689655
581	1529	36	1	0	37	1	0.02702702702702703
5810	1534	29	0	0	29	0	0
5811	1496	31	0	0	31	0	0
5812	1486	33	1	0	34	1	0.029411764705882353
5813	1505	29	3	0	32	3	0.09375
5814	1520	26	0	0	26	0	0
5815	1499	27	1	0	28	1	0.03571428571428571
5816	1544	38	1	1	40	2	0.05
5817	1516	29	0	0	29	0	0
5818	1488	41	0	0	41	0	0
5819	1514	29	0	0	29	0	0
582	1529	30	0	0	30	0	0
5820	1511	28	1	0	29	1	0.034482758620689655
5821	1477	35	0	0	35	0	0
5822	1523	35	0	0	35	0	0
5823	1515	38	2	0	40	2	0.05
5824	1506	35	0	0	35	0	0
5825	1502	26	0	0	26	0	0
5826	1515	34	3	0	37	3	0.08108108108108109
5827	1499	29	2	0	31	2	0.06451612903225806
5828	1519	33	1	0	34	1	0.029411764705882353
5829	1523	32	2	0	34	2	0.058823529411764705
583	1526	30	1	0	31	1	0.03225806451612903
5830	1489	23	3	0	26	3	0.11538461538461539
5831	1461	36	1	0	37	1	0.02702702702702703
5832	1534	18	0	0	18	0	0
5833	1497	34	0	0	34	0	0
5834	1510	23	1	0	24	1	0.041666666666666664
5835	1523	32	0	0	32	0	0
5836	1492	31	3	0	34	3	0.08823529411764706
5837	1518	27	1	0	28	1	0.03571428571428571
5838	1507	32	1	0	33	1	0.030303030303030304
5839	1508	39	1	0	40	1	0.025
584	1508	39	0	0	39	0	0
5840	1488	34	0	1	35	1	0.02857142857142857
5841	1518	22	0	0	22	0	0
5842	1508	22	1	0	23	1	0.043478260869565216
5843	1501	31	1	0	32	1	0.03125
5844	1509	37	0	0	37	0	0
5845	1558	29	0	0	29	0	0
5846	1544	42	1	0	43	1	0.023255813953488372
5847	1513	21	1	0	22	1	0.045454545454545456
5848	1486	34	0	0	34	0	0
5849	1510	34	1	0	35	1	0.02857142857142857
585	1486	36	1	0	37	1	0.02702702702702703
5850	1509	32	1	0	33	1	0.030303030303030304
5851	1529	31	3	0	34	3	0.08823529411764706
5852	1537	29	2	0	31	2	0.06451612903225806
5853	1480	32	3	0	35	3	0.08571428571428572
5854	1508	27	1	0	28	1	0.03571428571428571
5855	1521	25	0	0	25	0	0
5856	1525	20	3	0	23	3	0.13043478260869565
5857	1544	31	1	0	32	1	0.03125
5858	1520	29	3	0	32	3	0.09375
5859	1489	35	1	0	36	1	0.027777777777777776
586	1526	35	1	0	36	1	0.027777777777777776
5860	1564	36	1	0	37	1	0.02702702702702703
5861	1517	33	0	0	33	0	0
5862	1531	39	1	0	40	1	0.025
5863	1477	32	1	0	33	1	0.030303030303030304
5864	1498	21	0	0	21	0	0
5865	1503	28	0	0	28	0	0
5866	1523	20	1	0	21	1	0.047619047619047616
5867	1482	24	2	0	26	2	0.07692307692307693
5868	1520	34	0	0	34	0	0
5869	1477	42	0	0	42	0	0
587	1501	27	1	0	28	1	0.03571428571428571
5870	1502	30	1	0	31	1	0.03225806451612903
5871	1541	29	1	0	30	1	0.03333333333333333
5872	1505	30	1	0	31	1	0.03225806451612903
5873	1472	36	1	0	37	1	0.02702702702702703
5874	1490	26	0	0	26	0	0
5875	1478	36	0	0	36	0	0
5876	1503	35	0	0	35	0	0
5877	1507	36	1	0	37	1	0.02702702702702703
5878	1502	31	0	0	31	0	0
5879	1512	29	0	0	29	0	0
588	1505	33	0	0	33	0	0
5880	1501	28	0	0	28	0	0
5881	1515	37	1	0	38	1	0.02631578947368421
5882	1509	31	0	0	31	0	0
5883	1530	32	0	0	32	0	0
5884	1507	44	0	0	44	0	0
5885	1491	37	1	0	38	1	0.02631578947368421
5886	1514	31	1	0	32	1	0.03125
5887	1525	23	0	0	23	0	0
5888	1487	27	1	0	28	1	0.03571428571428571
5889	1513	30	2	0	32	2	0.0625
589	1532	27	0	0	27	0	0
5890	1474	28	1	0	29	1	0.034482758620689655
5891	1503	30	0	0	30	0	0
5892	1510	40	0	0	40	0	0
5893	1524	27	0	0	27	0	0
5894	1500	24	1	0	25	1	0.04
5895	1489	33	1	0	34	1	0.029411764705882353
5896	1503	31	1	0	32	1	0.03125
5897	1502	36	0	0	36	0	0
5898	1508	30	0	0	30	0	0
5899	1529	17	2	0	19	2	0.10526315789473684
59	1532	29	0	0	29	0	0
590	1522	28	0	0	28	0	0
5900	1527	26	1	0	27	1	0.037037037037037035
5901	1509	31	1	0	32	1	0.03125
5902	1508	26	3	0	29	3	0.10344827586206896
5903	1522	25	0	0	25	0	0
5904	1494	34	0	0	34	0	0
5905	1520	33	2	0	35	2	0.05714285714285714
5906	1517	39	1	0	40	1	0.025
5907	1509	31	0	0	31	0	0
5908	1536	39	1	0	40	1	0.025
5909	1543	32	0	0	32	0	0
591	1526	45	2	0	47	2	0.0425531914893617
5910	1504	24	3	0	27	3	0.1111111111111111
5911	1484	19	1	0	20	1	0.05
5912	1500	24	1	0	25	1	0.04
5913	1482	25	2	0	27	2	0.07407407407407407
5914	1497	36	1	0	37	1	0.02702702702702703
5915	1505	36	1	0	37	1	0.02702702702702703
5916	1521	33	1	0	34	1	0.029411764705882353
5917	1538	27	3	0	30	3	0.1
5918	1521	30	1	0	31	1	0.03225806451612903
5919	1511	21	0	0	21	0	0
592	1523	25	0	0	25	0	0
5920	1519	24	1	0	25	1	0.04
5921	1512	22	0	0	22	0	0
5922	1516	32	2	0	34	2	0.058823529411764705
5923	1521	29	2	0	31	2	0.06451612903225806
5924	1482	34	1	0	35	1	0.02857142857142857
5925	1545	33	5	0	38	5	0.13157894736842105
5926	1542	26	0	0	26	0	0
5927	1550	26	1	0	27	1	0.037037037037037035
5928	1560	34	3	0	37	3	0.08108108108108109
5929	1525	27	1	0	28	1	0.03571428571428571
593	1503	25	0	0	25	0	0
5930	1506	23	1	0	24	1	0.041666666666666664
5931	1516	32	1	0	33	1	0.030303030303030304
5932	1546	32	0	0	32	0	0
5933	1498	26	0	0	26	0	0
5934	1485	38	1	0	39	1	0.02564102564102564
5935	1535	29	2	0	31	2	0.06451612903225806
5936	1509	31	0	0	31	0	0
5937	1488	34	0	0	34	0	0
5938	1550	34	0	0	34	0	0
5939	1514	21	1	0	22	1	0.045454545454545456
594	1545	29	0	0	29	0	0
5940	1516	24	1	0	25	1	0.04
5941	1530	23	1	0	24	1	0.041666666666666664
5942	1499	24	1	0	25	1	0.04
5943	1537	34	2	0	36	2	0.05555555555555555
5944	1546	24	3	0	27	3	0.1111111111111111
5945	1499	33	1	0	34	1	0.029411764705882353
5946	1477	25	2	0	27	2	0.07407407407407407
5947	1502	21	1	0	22	1	0.045454545454545456
5948	1501	31	2	0	33	2	0.06060606060606061
5949	1513	39	1	0	40	1	0.025
595	1509	24	3	0	27	3	0.1111111111111111
5950	1525	26	1	0	27	1	0.037037037037037035
5951	1496	23	3	0	26	3	0.11538461538461539
5952	1468	32	2	0	34	2	0.058823529411764705
5953	1534	31	1	0	32	1	0.03125
5954	1509	34	0	0	34	0	0
5955	1534	33	1	0	34	1	0.029411764705882353
5956	1499	30	0	0	30	0	0
5957	1504	23	1	0	24	1	0.041666666666666664
5958	1518	31	0	0	31	0	0
5959	1559	30	0	0	30	0	0
596	1472	37	1	0	38	1	0.02631578947368421
5960	1497	38	0	0	38	0	0
5961	1532	28	2	0	30	2	0.06666666666666667
5962	1488	35	0	0	35	0	0
5963	1480	42	0	0	42	0	0
5964	1509	36	1	0	37	1	0.02702702702702703
5965	1513	30	1	0	31	1	0.03225806451612903
5966	1521	35	2	0	37	2	0.05405405405405406
5967	1489	33	2	0	35	2	0.05714285714285714
5968	1508	31	0	0	31	0	0
5969	1522	32	2	0	34	2	0.058823529411764705
597	1514	32	0	0	32	0	0
5970	1541	29	0	0	29	0	0
5971	1532	36	2	0	38	2	0.05263157894736842
5972	1499	37	0	0	37	0	0
5973	1490	37	1	0	38	1	0.02631578947368421
5974	1508	33	2	0	35	2	0.05714285714285714
5975	1515	26	0	0	26	0	0
5976	1471	28	1	0	29	1	0.034482758620689655
5977	1545	32	0	0	32	0	0
5978	1526	30	1	0	31	1	0.03225806451612903
5979	1516	31	0	0	31	0	0
598	1499	27	0	0	27	0	0
5980	1521	29	1	0	30	1	0.03333333333333333
5981	1506	29	1	0	30	1	0.03333333333333333
5982	1520	34	0	0	34	0	0
5983	1513	30	1	0	31	1	0.03225806451612903
5984	1469	28	0	0	28	0	0
5985	1493	38	0	0	38	0	0
5986	1508	27	1	1	29	2	0.06896551724137931
5987	1517	28	1	0	29	1	0.034482758620689655
5988	1530	26	3	1	30	4	0.13333333333333333
5989	1530	39	1	0	40	1	0.025
599	1491	26	0	0	26	0	0
5990	1516	24	1	0	25	1	0.04
5991	1484	21	2	0	23	2	0.08695652173913043
5992	1517	28	0	0	28	0	0
5993	1521	33	0	0	33	0	0
5994	1555	23	1	0	24	1	0.041666666666666664
5995	1556	24	3	0	27	3	0.1111111111111111
5996	1539	33	3	0	36	3	0.08333333333333333
5997	1491	35	0	0	35	0	0
5998	1500	25	1	0	26	1	0.038461538461538464
5999	1491	22	1	0	23	1	0.043478260869565216
6	1542	28	0	0	28	0	0
60	1531	30	0	0	30	0	0
600	1499	32	0	0	32	0	0
6000	1521	32	0	0	32	0	0
6001	1536	35	2	0	37	2	0.05405405405405406
6002	1491	31	0	0	31	0	0
6003	1493	35	0	0	35	0	0
6004	1519	24	0	1	25	1	0.04
6005	1525	33	0	0	33	0	0
6006	1505	34	0	0	34	0	0
6007	1508	23	1	0	24	1	0.041666666666666664
6008	1536	31	1	0	32	1	0.03125
6009	1532	24	1	0	25	1	0.04
601	1527	27	1	0	28	1	0.03571428571428571
6010	1495	31	1	0	32	1	0.03125
6011	1489	36	0	0	36	0	0
6012	1497	35	2	0	37	2	0.05405405405405406
6013	1494	34	0	0	34	0	0
6014	1507	29	1	0	30	1	0.03333333333333333
6015	1500	32	1	0	33	1	0.030303030303030304
6016	1538	50	3	0	53	3	0.05660377358490566
6017	1515	30	1	0	31	1	0.03225806451612903
6018	1514	24	0	0	24	0	0
6019	1495	34	2	0	36	2	0.05555555555555555
602	1540	29	1	0	30	1	0.03333333333333333
6020	1504	37	0	0	37	0	0
6021	1521	32	1	0	33	1	0.030303030303030304
6022	1532	34	1	0	35	1	0.02857142857142857
6023	1569	27	0	0	27	0	0
6024	1494	29	1	0	30	1	0.03333333333333333
6025	1528	24	0	0	24	0	0
6026	1539	27	0	0	27	0	0
6027	1499	29	1	0	30	1	0.03333333333333333
6028	1537	30	0	0	30	0	0
6029	1533	25	1	1	27	2	0.07407407407407407
603	1533	35	1	0	36	1	0.027777777777777776
6030	1520	20	2	0	22	2	0.09090909090909091
6031	1519	29	2	0	31	2	0.06451612903225806
6032	1505	37	0	0	37	0	0
6033	1498	28	2	0	30	2	0.06666666666666667
6034	1505	30	0	0	30	0	0
6035	1501	27	1	0	28	1	0.03571428571428571
6036	1497	36	0	0	36	0	0
6037	1507	25	1	0	26	1	0.038461538461538464
6038	1497	26	0	0	26	0	0
6039	1530	32	2	0	34	2	0.058823529411764705
604	1528	27	1	0	28	1	0.03571428571428571
6040	1508	17	2	0	19	2	0.10526315789473684
6041	1490	22	1	0	23	1	0.043478260869565216
6042	1512	32	4	0	36	4	0.1111111111111111
6043	1508	24	2	0	26	2	0.07692307692307693
6044	1512	37	0	0	37	0	0
6045	1480	23	0	0	23	0	0
6046	1503	25	1	0	26	1	0.038461538461538464
6047	1484	23	0	0	23	0	0
6048	1535	35	3	0	38	3	0.07894736842105263
6049	1504	35	1	0	36	1	0.027777777777777776
605	1511	25	1	0	26	1	0.038461538461538464
6050	1525	21	0	0	21	0	0
6051	1531	38	2	0	40	2	0.05
6052	1527	31	1	0	32	1	0.03125
6053	1524	40	0	0	40	0	0
6054	1518	31	1	0	32	1	0.03125
6055	1523	30	0	0	30	0	0
6056	1523	27	0	0	27	0	0
6057	1488	20	1	0	21	1	0.047619047619047616
6058	1512	29	1	0	30	1	0.03333333333333333
6059	1539	20	1	0	21	1	0.047619047619047616
606	1509	34	2	0	36	2	0.05555555555555555
6060	1528	32	0	0	32	0	0
6061	1508	30	0	0	30	0	0
6062	1496	26	0	0	26	0	0
6063	1496	19	2	0	21	2	0.09523809523809523
6064	1492	30	0	0	30	0	0
6065	1529	35	1	0	36	1	0.027777777777777776
6066	1487	33	1	0	34	1	0.029411764705882353
6067	1483	31	1	0	32	1	0.03125
6068	1474	34	0	0	34	0	0
6069	1506	31	1	0	32	1	0.03125
607	1502	33	0	0	33	0	0
6070	1501	39	0	0	39	0	0
6071	1491	35	0	0	35	0	0
6072	1529	23	1	0	24	1	0.041666666666666664
6073	1520	29	1	0	30	1	0.03333333333333333
6074	1494	26	2	0	28	2	0.07142857142857142
6075	1513	26	2	0	28	2	0.07142857142857142
6076	1537	39	1	0	40	1	0.025
6077	1489	28	2	0	30	2	0.06666666666666667
6078	1513	25	1	0	26	1	0.038461538461538464
6079	1540	28	1	0	29	1	0.034482758620689655
608	1508	31	1	0	32	1	0.03125
6080	1545	38	2	0	40	2	0.05
6081	1483	34	1	0	35	1	0.02857142857142857
6082	1473	28	0	0	28	0	0
6083	1549	29	2	0	31	2	0.06451612903225806
6084	1518	23	0	0	23	0	0
6085	1514	38	3	0	41	3	0.07317073170731707
6086	1514	38	0	0	38	0	0
6087	1559	29	0	0	29	0	0
6088	1509	26	0	0	26	0	0
6089	1482	28	3	0	31	3	0.0967741935483871
609	1514	28	2	0	30	2	0.06666666666666667
6090	1521	19	2	0	21	2	0.09523809523809523
6091	1497	35	3	0	38	3	0.07894736842105263
6092	1543	26	1	0	27	1	0.037037037037037035
6093	1496	32	0	0	32	0	0
6094	1540	20	0	0	20	0	0
6095	1498	32	2	0	34	2	0.058823529411764705
6096	1505	36	0	0	36	0	0
6097	1511	21	1	0	22	1	0.045454545454545456
6098	1507	28	0	0	28	0	0
6099	1545	29	1	0	30	1	0.03333333333333333
61	1541	31	1	0	32	1	0.03125
610	1490	29	1	0	30	1	0.03333333333333333
6100	1511	33	0	0	33	0	0
6101	1492	37	3	0	40	3	0.075
6102	1532	32	1	0	33	1	0.030303030303030304
6103	1486	34	0	0	34	0	0
6104	1521	28	2	0	30	2	0.06666666666666667
6105	1511	36	0	0	36	0	0
6106	1513	31	3	0	34	3	0.08823529411764706
6107	1502	46	2	0	48	2	0.041666666666666664
6108	1550	20	0	0	20	0	0
6109	1534	32	1	0	33	1	0.030303030303030304
611	1517	26	1	0	27	1	0.037037037037037035
6110	1494	25	1	0	26	1	0.038461538461538464
6111	1500	32	3	0	35	3	0.08571428571428572
6112	1492	39	1	0	40	1	0.025
6113	1526	32	1	0	33	1	0.030303030303030304
6114	1493	28	0	0	28	0	0
6115	1500	24	0	0	24	0	0
6116	1520	34	3	0	37	3	0.08108108108108109
6117	1498	33	0	0	33	0	0
6118	1493	37	2	0	39	2	0.05128205128205128
6119	1545	29	1	0	30	1	0.03333333333333333
612	1513	29	0	0	29	0	0
6120	1497	34	0	0	34	0	0
6121	1506	28	1	0	29	1	0.034482758620689655
6122	1537	24	0	0	24	0	0
6123	1518	21	0	0	21	0	0
6124	1489	31	0	0	31	0	0
6125	1493	29	0	0	29	0	0
6126	1512	18	1	0	19	1	0.05263157894736842
6127	1497	24	1	0	25	1	0.04
6128	1476	26	0	0	26	0	0
6129	1498	29	2	0	31	2	0.06451612903225806
613	1513	32	1	0	33	1	0.030303030303030304
6130	1526	29	1	0	30	1	0.03333333333333333
6131	1544	28	0	0	28	0	0
6132	1517	37	0	0	37	0	0
6133	1505	39	3	0	42	3	0.07142857142857142
6134	1507	37	1	0	38	1	0.02631578947368421
6135	1486	26	1	0	27	1	0.037037037037037035
6136	1513	37	0	0	37	0	0
6137	1536	27	1	0	28	1	0.03571428571428571
6138	1501	40	1	0	41	1	0.024390243902439025
6139	1499	31	1	0	32	1	0.03125
614	1545	35	0	0	35	0	0
6140	1495	38	1	0	39	1	0.02564102564102564
6141	1512	34	1	0	35	1	0.02857142857142857
6142	1516	38	1	0	39	1	0.02564102564102564
6143	1493	33	1	0	34	1	0.029411764705882353
6144	1525	32	1	0	33	1	0.030303030303030304
6145	1534	22	0	0	22	0	0
6146	1516	32	4	0	36	4	0.1111111111111111
6147	1505	34	0	0	34	0	0
6148	1502	28	2	0	30	2	0.06666666666666667
6149	1529	40	1	0	41	1	0.024390243902439025
615	1522	39	0	0	39	0	0
6150	1500	25	3	0	28	3	0.10714285714285714
6151	1535	29	0	0	29	0	0
6152	1521	33	1	0	34	1	0.029411764705882353
6153	1517	32	0	0	32	0	0
6154	1490	22	1	0	23	1	0.043478260869565216
6155	1501	19	4	0	23	4	0.17391304347826086
6156	1524	30	0	0	30	0	0
6157	1552	20	2	0	22	2	0.09090909090909091
6158	1506	32	2	0	34	2	0.058823529411764705
6159	1499	31	0	0	31	0	0
616	1524	31	0	0	31	0	0
6160	1498	26	0	0	26	0	0
6161	1523	27	0	0	27	0	0
6162	1564	23	2	0	25	2	0.08
6163	1533	35	2	0	37	2	0.05405405405405406
6164	1510	40	0	0	40	0	0
6165	1513	34	1	0	35	1	0.02857142857142857
6166	1490	21	0	0	21	0	0
6167	1530	30	0	0	30	0	0
6168	1523	30	4	0	34	4	0.11764705882352941
6169	1526	32	0	0	32	0	0
617	1534	29	2	0	31	2	0.06451612903225806
6170	1519	34	0	0	34	0	0
6171	1501	25	1	0	26	1	0.038461538461538464
6172	1522	33	1	0	34	1	0.029411764705882353
6173	1520	29	1	0	30	1	0.03333333333333333
6174	1512	26	1	0	27	1	0.037037037037037035
6175	1522	32	0	0	32	0	0
6176	1531	35	0	0	35	0	0
6177	1526	24	1	0	25	1	0.04
6178	1488	30	0	0	30	0	0
6179	1499	27	0	0	27	0	0
618	1506	22	1	0	23	1	0.043478260869565216
6180	1517	36	2	0	38	2	0.05263157894736842
6181	1511	28	1	1	30	2	0.06666666666666667
6182	1515	26	1	0	27	1	0.037037037037037035
6183	1531	34	0	0	34	0	0
6184	1532	27	1	0	28	1	0.03571428571428571
6185	1504	32	0	0	32	0	0
6186	1502	31	1	0	32	1	0.03125
6187	1513	36	0	0	36	0	0
6188	1514	39	1	0	40	1	0.025
6189	1524	28	1	0	29	1	0.034482758620689655
619	1488	31	4	0	35	4	0.11428571428571428
6190	1488	36	0	0	36	0	0
6191	1493	31	0	1	32	1	0.03125
6192	1515	22	3	0	25	3	0.12
6193	1500	18	0	0	18	0	0
6194	1490	31	1	0	32	1	0.03125
6195	1521	35	2	0	37	2	0.05405405405405406
6196	1523	30	1	0	31	1	0.03225806451612903
6197	1469	35	4	0	39	4	0.10256410256410256
6198	1499	28	1	0	29	1	0.034482758620689655
6199	1491	29	1	0	30	1	0.03333333333333333
62	1492	30	3	0	33	3	0.09090909090909091
620	1546	24	1	0	25	1	0.04
6200	1516	17	0	0	17	0	0
6201	1509	33	0	0	33	0	0
6202	1519	34	1	0	35	1	0.02857142857142857
6203	1518	30	0	0	30	0	0
6204	1512	25	1	0	26	1	0.038461538461538464
6205	1479	26	1	0	27	1	0.037037037037037035
6206	1529	31	1	0	32	1	0.03125
6207	1507	36	1	0	37	1	0.02702702702702703
6208	1518	33	1	0	34	1	0.029411764705882353
6209	1488	30	1	0	31	1	0.03225806451612903
621	1513	29	1	0	30	1	0.03333333333333333
6210	1517	34	0	0	34	0	0
6211	1487	34	2	0	36	2	0.05555555555555555
6212	1512	34	1	0	35	1	0.02857142857142857
6213	1485	44	0	0	44	0	0
6214	1509	33	0	0	33	0	0
6215	1473	39	0	0	39	0	0
6216	1483	25	1	0	26	1	0.038461538461538464
6217	1549	33	0	0	33	0	0
6218	1525	24	0	0	24	0	0
6219	1476	37	2	0	39	2	0.05128205128205128
622	1520	23	1	0	24	1	0.041666666666666664
6220	1511	27	2	0	29	2	0.06896551724137931
6221	1498	30	1	0	31	1	0.03225806451612903
6222	1514	29	0	0	29	0	0
6223	1538	35	1	0	36	1	0.027777777777777776
6224	1498	35	3	0	38	3	0.07894736842105263
6225	1508	31	1	0	32	1	0.03125
6226	1511	29	1	0	30	1	0.03333333333333333
6227	1575	26	1	0	27	1	0.037037037037037035
6228	1522	34	2	0	36	2	0.05555555555555555
6229	1471	26	1	0	27	1	0.037037037037037035
623	1529	19	0	0	19	0	0
6230	1507	21	0	0	21	0	0
6231	1511	40	2	0	42	2	0.047619047619047616
6232	1504	24	0	0	24	0	0
6233	1492	35	2	0	37	2	0.05405405405405406
6234	1485	21	1	0	22	1	0.045454545454545456
6235	1505	35	1	0	36	1	0.027777777777777776
6236	1513	22	1	0	23	1	0.043478260869565216
6237	1523	27	0	0	27	0	0
6238	1533	28	0	0	28	0	0
6239	1530	32	1	0	33	1	0.030303030303030304
624	1502	26	0	0	26	0	0
6240	1510	39	1	0	40	1	0.025
6241	1504	32	3	0	35	3	0.08571428571428572
6242	1466	27	1	0	28	1	0.03571428571428571
6243	1472	37	2	0	39	2	0.05128205128205128
6244	1538	36	2	0	38	2	0.05263157894736842
6245	1517	30	0	0	30	0	0
6246	1511	29	2	0	31	2	0.06451612903225806
6247	1515	24	1	0	25	1	0.04
6248	1504	31	0	0	31	0	0
6249	1521	36	1	0	37	1	0.02702702702702703
625	1487	30	0	0	30	0	0
6250	1539	31	2	0	33	2	0.06060606060606061
6251	1512	41	1	0	42	1	0.023809523809523808
6252	1512	35	0	0	35	0	0
6253	1551	29	0	0	29	0	0
6254	1493	31	0	0	31	0	0
6255	1501	33	2	0	35	2	0.05714285714285714
6256	1508	35	1	0	36	1	0.027777777777777776
6257	1532	34	0	0	34	0	0
6258	1479	23	0	0	23	0	0
6259	1530	23	1	0	24	1	0.041666666666666664
626	1489	28	0	0	28	0	0
6260	1500	30	2	0	32	2	0.0625
6261	1500	28	0	0	28	0	0
6262	1477	27	1	0	28	1	0.03571428571428571
6263	1541	28	1	0	29	1	0.034482758620689655
6264	1530	28	1	0	29	1	0.034482758620689655
6265	1503	31	2	0	33	2	0.06060606060606061
6266	1512	33	2	0	35	2	0.05714285714285714
6267	1514	22	0	0	22	0	0
6268	1538	26	3	0	29	3	0.10344827586206896
6269	1512	32	3	0	35	3	0.08571428571428572
627	1501	24	1	0	25	1	0.04
6270	1523	31	0	0	31	0	0
6271	1516	23	0	0	23	0	0
6272	1512	24	1	0	25	1	0.04
6273	1512	31	2	0	33	2	0.06060606060606061
6274	1491	22	0	0	22	0	0
6275	1489	31	1	0	32	1	0.03125
6276	1515	26	2	0	28	2	0.07142857142857142
6277	1513	38	0	0	38	0	0
6278	1498	30	1	0	31	1	0.03225806451612903
6279	1507	28	2	0	30	2	0.06666666666666667
628	1535	23	0	0	23	0	0
6280	1528	31	1	0	32	1	0.03125
6281	1505	27	0	0	27	0	0
6282	1513	32	2	0	34	2	0.058823529411764705
6283	1519	27	1	0	28	1	0.03571428571428571
6284	1468	29	1	0	30	1	0.03333333333333333
6285	1528	40	0	0	40	0	0
6286	1496	26	1	0	27	1	0.037037037037037035
6287	1525	26	2	0	28	2	0.07142857142857142
6288	1519	33	1	0	34	1	0.029411764705882353
6289	1503	31	0	0	31	0	0
629	1505	31	1	0	32	1	0.03125
6290	1524	27	0	0	27	0	0
6291	1500	43	1	0	44	1	0.022727272727272728
6292	1518	25	1	0	26	1	0.038461538461538464
6293	1540	30	1	0	31	1	0.03225806451612903
6294	1496	21	0	0	21	0	0
6295	1504	29	1	0	30	1	0.03333333333333333
6296	1475	30	1	0	31	1	0.03225806451612903
6297	1507	25	1	0	26	1	0.038461538461538464
6298	1526	22	1	0	23	1	0.043478260869565216
6299	1509	32	0	0	32	0	0
63	1498	24	0	0	24	0	0
630	1503	29	3	0	32	3	0.09375
6300	1526	31	2	0	33	2	0.06060606060606061
6301	1509	28	1	0	29	1	0.034482758620689655
6302	1542	31	2	0	33	2	0.06060606060606061
6303	1516	28	1	0	29	1	0.034482758620689655
6304	1480	28	1	0	29	1	0.034482758620689655
6305	1517	27	0	0	27	0	0
6306	1501	27	2	0	29	2	0.06896551724137931
6307	1525	28	1	0	29	1	0.034482758620689655
6308	1497	30	0	0	30	0	0
6309	1523	30	4	0	34	4	0.11764705882352941
631	1513	21	0	0	21	0	0
6310	1520	37	2	0	39	2	0.05128205128205128
6311	1518	39	0	0	39	0	0
6312	1527	39	3	0	42	3	0.07142857142857142
6313	1484	32	1	0	33	1	0.030303030303030304
6314	1532	31	1	0	32	1	0.03125
6315	1532	40	0	0	40	0	0
6316	1498	25	1	0	26	1	0.038461538461538464
6317	1496	34	1	0	35	1	0.02857142857142857
6318	1494	37	3	0	40	3	0.075
6319	1501	36	0	0	36	0	0
632	1510	28	3	0	31	3	0.0967741935483871
6320	1491	35	0	0	35	0	0
6321	1502	33	0	0	33	0	0
6322	1503	34	2	0	36	2	0.05555555555555555
6323	1503	41	2	0	43	2	0.046511627906976744
6324	1489	35	0	0	35	0	0
6325	1520	33	0	0	33	0	0
6326	1476	44	1	0	45	1	0.022222222222222223
6327	1505	37	1	0	38	1	0.02631578947368421
6328	1495	29	2	0	31	2	0.06451612903225806
6329	1498	35	1	0	36	1	0.027777777777777776
633	1504	33	1	0	34	1	0.029411764705882353
6330	1512	34	1	0	35	1	0.02857142857142857
6331	1511	23	3	0	26	3	0.11538461538461539
6332	1492	27	1	0	28	1	0.03571428571428571
6333	1523	27	1	0	28	1	0.03571428571428571
6334	1514	33	0	0	33	0	0
6335	1544	37	1	0	38	1	0.02631578947368421
6336	1486	23	1	0	24	1	0.041666666666666664
6337	1515	24	1	0	25	1	0.04
6338	1488	32	1	0	33	1	0.030303030303030304
6339	1516	34	1	0	35	1	0.02857142857142857
634	1527	36	0	0	36	0	0
6340	1468	31	1	0	32	1	0.03125
6341	1520	28	1	0	29	1	0.034482758620689655
6342	1550	34	2	0	36	2	0.05555555555555555
6343	1528	32	2	0	34	2	0.058823529411764705
6344	1502	35	0	0	35	0	0
6345	1514	35	0	0	35	0	0
6346	1523	29	0	0	29	0	0
6347	1520	17	1	0	18	1	0.05555555555555555
6348	1519	31	0	0	31	0	0
6349	1492	36	2	0	38	2	0.05263157894736842
635	1515	27	2	0	29	2	0.06896551724137931
6350	1497	30	0	0	30	0	0
6351	1537	37	3	0	40	3	0.075
6352	1533	31	0	0	31	0	0
6353	1512	24	1	0	25	1	0.04
6354	1503	32	1	0	33	1	0.030303030303030304
6355	1498	28	2	0	30	2	0.06666666666666667
6356	1511	39	0	0	39	0	0
6357	1532	26	0	0	26	0	0
6358	1498	25	1	0	26	1	0.038461538461538464
6359	1513	37	1	0	38	1	0.02631578947368421
636	1519	22	2	0	24	2	0.08333333333333333
6360	1512	29	0	0	29	0	0
6361	1513	29	1	0	30	1	0.03333333333333333
6362	1491	26	1	0	27	1	0.037037037037037035
6363	1542	31	0	0	31	0	0
6364	1551	24	0	0	24	0	0
6365	1517	46	2	0	48	2	0.041666666666666664
6366	1534	25	1	0	26	1	0.038461538461538464
6367	1473	33	2	0	35	2	0.05714285714285714
6368	1536	24	0	0	24	0	0
6369	1519	27	1	0	28	1	0.03571428571428571
637	1504	28	0	0	28	0	0
6370	1495	26	1	0	27	1	0.037037037037037035
6371	1519	24	0	0	24	0	0
6372	1512	31	1	0	32	1	0.03125
6373	1541	30	1	0	31	1	0.03225806451612903
6374	1499	36	2	0	38	2	0.05263157894736842
6375	1513	22	0	0	22	0	0
6376	1506	37	0	0	37	0	0
6377	1503	30	0	0	30	0	0
6378	1488	29	0	0	29	0	0
6379	1532	27	0	0	27	0	0
638	1543	37	2	0	39	2	0.05128205128205128
6380	1533	20	0	0	20	0	0
6381	1461	27	2	0	29	2	0.06896551724137931
6382	1510	25	1	0	26	1	0.038461538461538464
6383	1513	27	1	0	28	1	0.03571428571428571
6384	1519	26	1	0	27	1	0.037037037037037035
6385	1500	27	0	0	27	0	0
6386	1473	31	1	0	32	1	0.03125
6387	1531	41	1	0	42	1	0.023809523809523808
6388	1508	32	1	0	33	1	0.030303030303030304
6389	1475	23	2	0	25	2	0.08
639	1487	30	2	0	32	2	0.0625
6390	1476	28	0	0	28	0	0
6391	1459	27	0	0	27	0	0
6392	1522	34	1	0	35	1	0.02857142857142857
6393	1489	36	0	0	36	0	0
6394	1546	32	1	0	33	1	0.030303030303030304
6395	1538	39	1	0	40	1	0.025
6396	1529	30	3	0	33	3	0.09090909090909091
6397	1517	41	1	0	42	1	0.023809523809523808
6398	1513	31	0	0	31	0	0
6399	1537	34	0	0	34	0	0
64	1522	38	0	0	38	0	0
640	1501	26	1	0	27	1	0.037037037037037035
6400	1489	32	1	0	33	1	0.030303030303030304
6401	1528	23	1	0	24	1	0.041666666666666664
6402	1535	26	0	0	26	0	0
6403	1483	25	1	0	26	1	0.038461538461538464
6404	1508	32	1	0	33	1	0.030303030303030304
6405	1509	28	2	0	30	2	0.06666666666666667
6406	1536	25	2	0	27	2	0.07407407407407407
6407	1520	29	2	0	31	2	0.06451612903225806
6408	1503	28	1	0	29	1	0.034482758620689655
6409	1510	32	0	0	32	0	0
641	1537	27	1	0	28	1	0.03571428571428571
6410	1503	29	2	0	31	2	0.06451612903225806
6411	1522	28	1	1	30	2	0.06666666666666667
6412	1519	32	1	0	33	1	0.030303030303030304
6413	1520	25	2	0	27	2	0.07407407407407407
6414	1502	30	2	0	32	2	0.0625
6415	1531	23	3	0	26	3	0.11538461538461539
6416	1503	28	0	0	28	0	0
6417	1466	32	2	0	34	2	0.058823529411764705
6418	1496	26	2	0	28	2	0.07142857142857142
6419	1495	33	1	0	34	1	0.029411764705882353
642	1515	32	0	0	32	0	0
6420	1485	40	0	0	40	0	0
6421	1510	28	3	0	31	3	0.0967741935483871
6422	1511	27	0	0	27	0	0
6423	1538	26	2	0	28	2	0.07142857142857142
6424	1545	28	0	0	28	0	0
6425	1509	28	1	1	30	2	0.06666666666666667
6426	1514	39	3	0	42	3	0.07142857142857142
6427	1492	33	0	0	33	0	0
6428	1501	36	0	0	36	0	0
6429	1509	33	2	0	35	2	0.05714285714285714
643	1528	29	1	0	30	1	0.03333333333333333
6430	1512	34	1	0	35	1	0.02857142857142857
6431	1525	26	1	0	27	1	0.037037037037037035
6432	1493	45	0	0	45	0	0
6433	1535	26	0	0	26	0	0
6434	1524	31	0	0	31	0	0
6435	1502	31	1	0	32	1	0.03125
6436	1506	27	1	0	28	1	0.03571428571428571
6437	1519	26	2	0	28	2	0.07142857142857142
6438	1502	39	1	0	40	1	0.025
6439	1526	23	1	0	24	1	0.041666666666666664
644	1493	36	0	0	36	0	0
6440	1514	26	0	0	26	0	0
6441	1534	32	0	0	32	0	0
6442	1487	36	0	0	36	0	0
6443	1487	22	1	0	23	1	0.043478260869565216
6444	1500	24	1	0	25	1	0.04
6445	1468	26	0	0	26	0	0
6446	1494	35	0	0	35	0	0
6447	1523	25	0	0	25	0	0
6448	1507	31	1	0	32	1	0.03125
6449	1493	29	3	0	32	3	0.09375
645	1524	22	2	0	24	2	0.08333333333333333
6450	1503	32	0	0	32	0	0
6451	1540	29	2	0	31	2	0.06451612903225806
6452	1487	26	0	0	26	0	0
6453	1520	29	0	0	29	0	0
6454	1508	34	0	0	34	0	0
6455	1508	27	1	0	28	1	0.03571428571428571
6456	1519	29	1	0	30	1	0.03333333333333333
6457	1533	40	0	0	40	0	0
6458	1480	30	2	0	32	2	0.0625
6459	1487	34	1	0	35	1	0.02857142857142857
646	1496	33	2	0	35	2	0.05714285714285714
6460	1548	46	1	0	47	1	0.02127659574468085
6461	1487	33	0	0	33	0	0
6462	1510	34	0	0	34	0	0
6463	1525	38	1	0	39	1	0.02564102564102564
6464	1499	27	0	0	27	0	0
6465	1495	40	1	0	41	1	0.024390243902439025
6466	1517	18	0	0	18	0	0
6467	1536	38	0	0	38	0	0
6468	1545	29	1	0	30	1	0.03333333333333333
6469	1501	42	0	0	42	0	0
647	1523	34	2	0	36	2	0.05555555555555555
6470	1485	35	1	0	36	1	0.027777777777777776
6471	1500	27	1	0	28	1	0.03571428571428571
6472	1506	34	0	0	34	0	0
6473	1511	26	1	0	27	1	0.037037037037037035
6474	1509	32	0	0	32	0	0
6475	1524	39	0	0	39	0	0
6476	1538	23	0	0	23	0	0
6477	1512	33	2	0	35	2	0.05714285714285714
6478	1520	34	0	1	35	1	0.02857142857142857
6479	1512	27	1	0	28	1	0.03571428571428571
648	1513	31	2	0	33	2	0.06060606060606061
6480	1559	39	0	0	39	0	0
6481	1509	31	1	0	32	1	0.03125
6482	1514	31	1	0	32	1	0.03125
6483	1495	23	1	0	24	1	0.041666666666666664
6484	1487	34	2	0	36	2	0.05555555555555555
6485	1521	26	1	0	27	1	0.037037037037037035
6486	1519	40	1	0	41	1	0.024390243902439025
6487	1472	34	2	0	36	2	0.05555555555555555
6488	1487	26	1	0	27	1	0.037037037037037035
6489	1520	40	4	0	44	4	0.09090909090909091
649	1551	23	3	0	26	3	0.11538461538461539
6490	1519	29	2	0	31	2	0.06451612903225806
6491	1511	26	0	0	26	0	0
6492	1503	42	0	0	42	0	0
6493	1494	27	2	0	29	2	0.06896551724137931
6494	1513	34	1	0	35	1	0.02857142857142857
6495	1520	29	1	0	30	1	0.03333333333333333
6496	1499	32	0	0	32	0	0
6497	1527	28	2	0	30	2	0.06666666666666667
6498	1501	31	0	0	31	0	0
6499	1504	34	1	0	35	1	0.02857142857142857
65	1497	29	1	0	30	1	0.03333333333333333
650	1499	30	1	0	31	1	0.03225806451612903
6500	1507	28	2	0	30	2	0.06666666666666667
6501	1507	30	0	0	30	0	0
6502	1508	33	1	0	34	1	0.029411764705882353
6503	1501	38	1	0	39	1	0.02564102564102564
6504	1498	35	1	0	36	1	0.027777777777777776
6505	1502	34	1	0	35	1	0.02857142857142857
6506	1522	34	0	0	34	0	0
6507	1525	30	1	0	31	1	0.03225806451612903
6508	1526	41	1	0	42	1	0.023809523809523808
6509	1518	24	0	0	24	0	0
651	1491	34	0	0	34	0	0
6510	1479	33	0	0	33	0	0
6511	1504	27	1	0	28	1	0.03571428571428571
6512	1534	30	2	0	32	2	0.0625
6513	1515	30	2	0	32	2	0.0625
6514	1488	34	0	0	34	0	0
6515	1495	20	0	0	20	0	0
6516	1525	27	0	0	27	0	0
6517	1531	35	1	0	36	1	0.027777777777777776
6518	1514	30	1	0	31	1	0.03225806451612903
6519	1508	39	1	0	40	1	0.025
652	1480	22	0	0	22	0	0
6520	1483	40	1	0	41	1	0.024390243902439025
6521	1499	31	1	0	32	1	0.03125
6522	1519	34	1	0	35	1	0.02857142857142857
6523	1501	35	1	0	36	1	0.027777777777777776
6524	1483	28	1	0	29	1	0.034482758620689655
6525	1502	30	2	0	32	2	0.0625
6526	1521	30	1	0	31	1	0.03225806451612903
6527	1503	35	3	0	38	3	0.07894736842105263
6528	1529	42	0	0	42	0	0
6529	1506	39	1	0	40	1	0.025
653	1539	28	1	0	29	1	0.034482758620689655
6530	1508	33	1	0	34	1	0.029411764705882353
6531	1492	18	1	0	19	1	0.05263157894736842
6532	1489	29	1	0	30	1	0.03333333333333333
6533	1482	36	0	0	36	0	0
6534	1518	28	0	0	28	0	0
6535	1486	20	1	0	21	1	0.047619047619047616
6536	1483	25	1	0	26	1	0.038461538461538464
6537	1524	34	0	0	34	0	0
6538	1519	33	0	0	33	0	0
6539	1468	30	0	0	30	0	0
654	1546	26	0	0	26	0	0
6540	1493	30	1	0	31	1	0.03225806451612903
6541	1500	28	0	0	28	0	0
6542	1482	29	1	0	30	1	0.03333333333333333
6543	1466	41	1	0	42	1	0.023809523809523808
6544	1514	33	1	1	35	2	0.05714285714285714
6545	1529	33	2	0	35	2	0.05714285714285714
6546	1495	27	2	0	29	2	0.06896551724137931
6547	1518	26	0	0	26	0	0
6548	1523	33	0	0	33	0	0
6549	1547	42	2	0	44	2	0.045454545454545456
655	1523	32	1	0	33	1	0.030303030303030304
6550	1511	28	0	0	28	0	0
6551	1490	24	0	0	24	0	0
6552	1512	41	1	0	42	1	0.023809523809523808
6553	1548	37	0	0	37	0	0
6554	1523	28	1	0	29	1	0.034482758620689655
6555	1507	21	2	0	23	2	0.08695652173913043
6556	1531	29	1	0	30	1	0.03333333333333333
6557	1474	29	2	0	31	2	0.06451612903225806
6558	1512	28	2	0	30	2	0.06666666666666667
6559	1479	27	0	0	27	0	0
656	1543	16	0	0	16	0	0
6560	1503	21	0	0	21	0	0
6561	1522	28	3	0	31	3	0.0967741935483871
6562	1502	33	1	0	34	1	0.029411764705882353
6563	1536	27	0	0	27	0	0
6564	1485	31	2	0	33	2	0.06060606060606061
6565	1514	21	2	0	23	2	0.08695652173913043
6566	1516	22	0	0	22	0	0
6567	1505	30	0	0	30	0	0
6568	1551	29	1	0	30	1	0.03333333333333333
6569	1493	22	0	0	22	0	0
657	1558	32	0	0	32	0	0
6570	1497	38	1	0	39	1	0.02564102564102564
6571	1521	33	2	0	35	2	0.05714285714285714
6572	1543	35	0	0	35	0	0
6573	1517	31	0	0	31	0	0
6574	1504	34	0	0	34	0	0
6575	1488	26	0	0	26	0	0
6576	1511	37	0	0	37	0	0
6577	1512	27	2	0	29	2	0.06896551724137931
6578	1526	36	0	0	36	0	0
6579	1514	33	1	0	34	1	0.029411764705882353
658	1515	36	0	0	36	0	0
6580	1484	27	0	0	27	0	0
6581	1541	32	1	0	33	1	0.030303030303030304
6582	1478	26	2	0	28	2	0.07142857142857142
6583	1528	30	1	0	31	1	0.03225806451612903
6584	1520	34	2	0	36	2	0.05555555555555555
6585	1514	33	0	0	33	0	0
6586	1493	39	0	0	39	0	0
6587	1522	37	1	0	38	1	0.02631578947368421
6588	1504	30	0	0	30	0	0
6589	1489	35	2	0	37	2	0.05405405405405406
659	1525	25	1	0	26	1	0.038461538461538464
6590	1504	33	0	0	33	0	0
6591	1528	26	0	0	26	0	0
6592	1536	27	0	0	27	0	0
6593	1519	22	1	0	23	1	0.043478260869565216
6594	1543	38	3	0	41	3	0.07317073170731707
6595	1541	37	0	0	37	0	0
6596	1509	24	0	0	24	0	0
6597	1478	35	0	0	35	0	0
6598	1522	27	2	0	29	2	0.06896551724137931
6599	1546	37	2	0	39	2	0.05128205128205128
66	1540	24	1	0	25	1	0.04
660	1515	36	2	0	38	2	0.05263157894736842
6600	1518	33	0	0	33	0	0
6601	1497	32	1	0	33	1	0.030303030303030304
6602	1514	29	3	0	32	3	0.09375
6603	1498	29	0	0	29	0	0
6604	1535	27	5	0	32	5	0.15625
6605	1480	31	1	0	32	1	0.03125
6606	1512	26	0	0	26	0	0
6607	1520	19	3	0	22	3	0.13636363636363635
6608	1496	28	0	0	28	0	0
6609	1518	29	1	0	30	1	0.03333333333333333
661	1524	30	1	0	31	1	0.03225806451612903
6610	1539	33	1	0	34	1	0.029411764705882353
6611	1544	25	0	0	25	0	0
6612	1525	33	0	0	33	0	0
6613	1503	31	2	0	33	2	0.06060606060606061
6614	1525	28	2	0	30	2	0.06666666666666667
6615	1513	28	1	0	29	1	0.034482758620689655
6616	1521	27	3	0	30	3	0.1
6617	1525	24	2	0	26	2	0.07692307692307693
6618	1488	28	1	0	29	1	0.034482758620689655
6619	1455	34	0	0	34	0	0
662	1503	28	0	0	28	0	0
6620	1488	35	2	0	37	2	0.05405405405405406
6621	1493	20	2	0	22	2	0.09090909090909091
6622	1528	21	1	0	22	1	0.045454545454545456
6623	1528	27	0	0	27	0	0
6624	1500	33	1	0	34	1	0.029411764705882353
6625	1483	25	2	0	27	2	0.07407407407407407
6626	1528	29	2	0	31	2	0.06451612903225806
6627	1516	30	0	0	30	0	0
6628	1521	40	0	0	40	0	0
6629	1483	28	1	0	29	1	0.034482758620689655
663	1506	29	2	0	31	2	0.06451612903225806
6630	1507	32	0	0	32	0	0
6631	1532	40	2	0	42	2	0.047619047619047616
6632	1553	38	0	1	39	1	0.02564102564102564
6633	1486	32	0	0	32	0	0
6634	1515	32	3	0	35	3	0.08571428571428572
6635	1482	33	2	0	35	2	0.05714285714285714
6636	1516	21	0	0	21	0	0
6637	1498	24	0	0	24	0	0
6638	1476	27	0	0	27	0	0
6639	1532	32	1	0	33	1	0.030303030303030304
664	1488	28	0	0	28	0	0
6640	1512	29	0	1	30	1	0.03333333333333333
6641	1510	28	1	0	29	1	0.034482758620689655
6642	1525	23	0	0	23	0	0
6643	1481	28	2	0	30	2	0.06666666666666667
6644	1508	38	2	0	40	2	0.05
6645	1555	36	2	0	38	2	0.05263157894736842
6646	1484	35	4	0	39	4	0.10256410256410256
6647	1489	27	0	0	27	0	0
6648	1499	25	1	0	26	1	0.038461538461538464
6649	1488	27	0	0	27	0	0
665	1578	37	0	0	37	0	0
6650	1464	33	1	0	34	1	0.029411764705882353
6651	1494	31	1	0	32	1	0.03125
6652	1530	28	1	0	29	1	0.034482758620689655
6653	1539	27	1	0	28	1	0.03571428571428571
6654	1525	34	0	0	34	0	0
6655	1515	30	1	0	31	1	0.03225806451612903
6656	1515	35	1	0	36	1	0.027777777777777776
6657	1506	23	0	0	23	0	0
6658	1534	26	1	0	27	1	0.037037037037037035
6659	1515	28	0	0	28	0	0
666	1528	32	0	0	32	0	0
6660	1485	30	2	0	32	2	0.0625
6661	1491	25	1	0	26	1	0.038461538461538464
6662	1519	38	1	0	39	1	0.02564102564102564
6663	1513	27	1	0	28	1	0.03571428571428571
6664	1490	35	1	0	36	1	0.027777777777777776
6665	1510	27	2	0	29	2	0.06896551724137931
6666	1520	29	1	0	30	1	0.03333333333333333
6667	1530	36	0	0	36	0	0
6668	1526	29	1	0	30	1	0.03333333333333333
6669	1516	25	0	0	25	0	0
667	1511	34	2	0	36	2	0.05555555555555555
6670	1505	26	0	0	26	0	0
6671	1483	31	0	0	31	0	0
6672	1504	27	1	0	28	1	0.03571428571428571
6673	1524	28	1	1	30	2	0.06666666666666667
6674	1542	31	1	0	32	1	0.03125
6675	1531	39	0	0	39	0	0
6676	1501	37	0	0	37	0	0
6677	1529	27	1	0	28	1	0.03571428571428571
6678	1530	34	0	0	34	0	0
6679	1532	31	1	0	32	1	0.03125
668	1515	34	1	0	35	1	0.02857142857142857
6680	1493	23	2	0	25	2	0.08
6681	1525	35	2	0	37	2	0.05405405405405406
6682	1442	44	2	0	46	2	0.043478260869565216
6683	1485	31	1	0	32	1	0.03125
6684	1534	34	0	0	34	0	0
6685	1496	23	0	0	23	0	0
6686	1527	28	2	0	30	2	0.06666666666666667
6687	1545	25	1	0	26	1	0.038461538461538464
6688	1509	25	1	0	26	1	0.038461538461538464
6689	1499	26	1	0	27	1	0.037037037037037035
669	1536	35	2	0	37	2	0.05405405405405406
6690	1523	29	2	0	31	2	0.06451612903225806
6691	1498	45	0	0	45	0	0
6692	1527	37	1	0	38	1	0.02631578947368421
6693	1510	31	1	0	32	1	0.03125
6694	1480	34	0	0	34	0	0
6695	1515	30	1	0	31	1	0.03225806451612903
6696	1494	27	1	0	28	1	0.03571428571428571
6697	1525	41	0	0	41	0	0
6698	1546	29	0	0	29	0	0
6699	1493	32	1	0	33	1	0.030303030303030304
67	1525	32	1	0	33	1	0.030303030303030304
670	1527	37	2	0	39	2	0.05128205128205128
6700	1511	21	1	0	22	1	0.045454545454545456
6701	1483	37	1	0	38	1	0.02631578947368421
6702	1525	29	0	0	29	0	0
6703	1524	28	1	0	29	1	0.034482758620689655
6704	1506	39	0	0	39	0	0
6705	1526	29	1	0	30	1	0.03333333333333333
6706	1552	35	0	0	35	0	0
6707	1498	32	1	0	33	1	0.030303030303030304
6708	1508	21	2	0	23	2	0.08695652173913043
6709	1543	28	0	0	28	0	0
671	1545	29	0	0	29	0	0
6710	1509	33	2	0	35	2	0.05714285714285714
6711	1514	24	1	0	25	1	0.04
6712	1507	31	0	0	31	0	0
6713	1523	24	1	0	25	1	0.04
6714	1527	24	0	0	24	0	0
6715	1523	31	1	0	32	1	0.03125
6716	1494	30	0	0	30	0	0
6717	1521	39	0	0	39	0	0
6718	1513	25	1	0	26	1	0.038461538461538464
6719	1514	27	1	0	28	1	0.03571428571428571
672	1488	32	0	0	32	0	0
6720	1528	26	1	0	27	1	0.037037037037037035
6721	1534	26	1	0	27	1	0.037037037037037035
6722	1506	34	1	0	35	1	0.02857142857142857
6723	1517	26	1	0	27	1	0.037037037037037035
6724	1509	24	0	0	24	0	0
6725	1514	28	1	0	29	1	0.034482758620689655
6726	1521	30	1	0	31	1	0.03225806451612903
6727	1532	39	1	0	40	1	0.025
6728	1511	31	0	0	31	0	0
6729	1514	42	2	0	44	2	0.045454545454545456
673	1499	38	0	0	38	0	0
6730	1525	31	1	0	32	1	0.03125
6731	1515	22	0	0	22	0	0
6732	1507	29	1	0	30	1	0.03333333333333333
6733	1528	31	0	0	31	0	0
6734	1504	24	1	0	25	1	0.04
6735	1515	33	2	0	35	2	0.05714285714285714
6736	1514	23	0	0	23	0	0
6737	1470	32	1	0	33	1	0.030303030303030304
6738	1498	27	1	0	28	1	0.03571428571428571
6739	1504	35	1	0	36	1	0.027777777777777776
674	1473	28	1	0	29	1	0.034482758620689655
6740	1519	14	2	0	16	2	0.125
6741	1521	36	1	0	37	1	0.02702702702702703
6742	1492	31	1	0	32	1	0.03125
6743	1520	34	1	0	35	1	0.02857142857142857
6744	1511	32	2	0	34	2	0.058823529411764705
6745	1531	28	0	0	28	0	0
6746	1524	33	3	0	36	3	0.08333333333333333
6747	1502	33	1	0	34	1	0.029411764705882353
6748	1528	25	4	0	29	4	0.13793103448275862
6749	1551	30	0	0	30	0	0
675	1483	30	0	0	30	0	0
6750	1519	24	2	0	26	2	0.07692307692307693
6751	1474	27	0	0	27	0	0
6752	1530	30	3	0	33	3	0.09090909090909091
6753	1483	25	1	0	26	1	0.038461538461538464
6754	1487	38	1	0	39	1	0.02564102564102564
6755	1513	34	1	1	36	2	0.05555555555555555
6756	1528	34	0	0	34	0	0
6757	1530	32	0	0	32	0	0
6758	1527	22	1	0	23	1	0.043478260869565216
6759	1521	42	2	0	44	2	0.045454545454545456
676	1510	28	0	0	28	0	0
6760	1517	28	1	0	29	1	0.034482758620689655
6761	1519	30	1	0	31	1	0.03225806451612903
6762	1509	35	0	0	35	0	0
6763	1509	36	1	0	37	1	0.02702702702702703
6764	1519	42	0	0	42	0	0
6765	1495	25	2	0	27	2	0.07407407407407407
6766	1500	39	2	0	41	2	0.04878048780487805
6767	1541	27	0	0	27	0	0
6768	1482	33	2	0	35	2	0.05714285714285714
6769	1507	23	1	0	24	1	0.041666666666666664
677	1538	21	1	0	22	1	0.045454545454545456
6770	1524	25	0	0	25	0	0
6771	1506	23	0	0	23	0	0
6772	1522	22	1	0	23	1	0.043478260869565216
6773	1496	39	1	0	40	1	0.025
6774	1548	20	1	0	21	1	0.047619047619047616
6775	1544	35	2	0	37	2	0.05405405405405406
6776	1508	38	2	0	40	2	0.05
6777	1524	33	0	0	33	0	0
6778	1527	30	3	0	33	3	0.09090909090909091
6779	1534	36	3	0	39	3	0.07692307692307693
678	1521	28	0	0	28	0	0
6780	1499	31	1	0	32	1	0.03125
6781	1532	35	0	0	35	0	0
6782	1501	40	0	0	40	0	0
6783	1507	23	0	0	23	0	0
6784	1485	32	0	0	32	0	0
6785	1514	37	0	0	37	0	0
6786	1519	33	2	0	35	2	0.05714285714285714
6787	1518	36	2	0	38	2	0.05263157894736842
6788	1539	25	1	0	26	1	0.038461538461538464
6789	1502	29	3	0	32	3	0.09375
679	1492	34	1	0	35	1	0.02857142857142857
6790	1509	29	0	0	29	0	0
6791	1490	29	1	0	30	1	0.03333333333333333
6792	1500	26	2	0	28	2	0.07142857142857142
6793	1486	40	1	0	41	1	0.024390243902439025
6794	1504	28	1	0	29	1	0.034482758620689655
6795	1502	31	1	0	32	1	0.03125
6796	1511	41	0	0	41	0	0
6797	1510	31	0	0	31	0	0
6798	1492	29	2	0	31	2	0.06451612903225806
6799	1501	28	0	0	28	0	0
68	1505	26	2	0	28	2	0.07142857142857142
680	1510	27	2	0	29	2	0.06896551724137931
6800	1500	29	1	0	30	1	0.03333333333333333
6801	1519	31	2	0	33	2	0.06060606060606061
6802	1512	33	0	0	33	0	0
6803	1497	25	0	0	25	0	0
6804	1519	29	0	0	29	0	0
6805	1504	22	0	0	22	0	0
6806	1492	33	1	0	34	1	0.029411764705882353
6807	1530	34	1	0	35	1	0.02857142857142857
6808	1503	39	1	0	40	1	0.025
6809	1488	29	2	0	31	2	0.06451612903225806
681	1509	29	1	0	30	1	0.03333333333333333
6810	1500	27	1	0	28	1	0.03571428571428571
6811	1506	39	0	0	39	0	0
6812	1512	32	1	0	33	1	0.030303030303030304
6813	1540	34	1	0	35	1	0.02857142857142857
6814	1477	29	0	0	29	0	0
6815	1500	27	0	0	27	0	0
6816	1502	30	1	0	31	1	0.03225806451612903
6817	1531	29	1	0	30	1	0.03333333333333333
6818	1508	22	0	0	22	0	0
6819	1490	31	1	0	32	1	0.03125
682	1492	24	1	0	25	1	0.04
6820	1534	25	0	0	25	0	0
6821	1495	25	3	0	28	3	0.10714285714285714
6822	1531	43	0	0	43	0	0
6823	1497	25	3	0	28	3	0.10714285714285714
6824	1510	32	0	0	32	0	0
6825	1525	32	2	0	34	2	0.058823529411764705
6826	1497	27	1	0	28	1	0.03571428571428571
6827	1526	22	1	0	23	1	0.043478260869565216
6828	1502	40	0	0	40	0	0
6829	1512	29	0	0	29	0	0
683	1501	34	3	0	37	3	0.08108108108108109
6830	1505	29	1	0	30	1	0.03333333333333333
6831	1501	32	0	0	32	0	0
6832	1476	28	2	0	30	2	0.06666666666666667
6833	1529	32	0	0	32	0	0
6834	1502	39	1	0	40	1	0.025
6835	1547	33	3	0	36	3	0.08333333333333333
6836	1510	28	3	0	31	3	0.0967741935483871
6837	1524	24	0	0	24	0	0
6838	1538	29	2	0	31	2	0.06451612903225806
6839	1522	36	1	0	37	1	0.02702702702702703
684	1527	21	0	0	21	0	0
6840	1508	29	2	0	31	2	0.06451612903225806
6841	1509	38	0	0	38	0	0
6842	1535	24	1	0	25	1	0.04
6843	1511	36	1	0	37	1	0.02702702702702703
6844	1534	24	1	0	25	1	0.04
6845	1513	37	1	0	38	1	0.02631578947368421
6846	1508	30	1	0	31	1	0.03225806451612903
6847	1510	33	0	0	33	0	0
6848	1507	28	0	0	28	0	0
6849	1502	24	1	0	25	1	0.04
685	1509	29	0	0	29	0	0
6850	1505	41	1	0	42	1	0.023809523809523808
6851	1528	34	0	0	34	0	0
6852	1495	35	1	0	36	1	0.027777777777777776
6853	1525	33	0	0	33	0	0
6854	1520	23	2	0	25	2	0.08
6855	1519	31	2	0	33	2	0.06060606060606061
6856	1531	33	2	0	35	2	0.05714285714285714
6857	1501	23	1	0	24	1	0.041666666666666664
6858	1558	35	0	0	35	0	0
6859	1527	36	0	0	36	0	0
686	1501	36	0	0	36	0	0
6860	1485	32	1	0	33	1	0.030303030303030304
6861	1514	30	0	0	30	0	0
6862	1487	34	0	0	34	0	0
6863	1475	25	0	0	25	0	0
6864	1532	40	0	0	40	0	0
6865	1496	38	0	0	38	0	0
6866	1552	35	1	0	36	1	0.027777777777777776
6867	1531	23	0	0	23	0	0
6868	1507	37	1	0	38	1	0.02631578947368421
6869	1532	23	0	0	23	0	0
687	1512	33	0	0	33	0	0
6870	1510	31	1	0	32	1	0.03125
6871	1495	31	1	0	32	1	0.03125
6872	1520	37	0	0	37	0	0
6873	1476	35	4	0	39	4	0.10256410256410256
6874	1509	30	0	0	30	0	0
6875	1498	37	0	1	38	1	0.02631578947368421
6876	1505	24	1	0	25	1	0.04
6877	1486	39	3	0	42	3	0.07142857142857142
6878	1546	21	2	0	23	2	0.08695652173913043
6879	1520	25	1	0	26	1	0.038461538461538464
688	1522	28	0	0	28	0	0
6880	1525	32	1	0	33	1	0.030303030303030304
6881	1525	33	1	0	34	1	0.029411764705882353
6882	1540	31	2	0	33	2	0.06060606060606061
6883	1494	43	1	0	44	1	0.022727272727272728
6884	1502	35	0	0	35	0	0
6885	1538	25	1	0	26	1	0.038461538461538464
6886	1533	31	1	0	32	1	0.03125
6887	1492	40	1	1	42	2	0.047619047619047616
6888	1517	40	1	0	41	1	0.024390243902439025
6889	1513	28	3	0	31	3	0.0967741935483871
689	1512	29	1	0	30	1	0.03333333333333333
6890	1512	23	2	0	25	2	0.08
6891	1500	30	1	0	31	1	0.03225806451612903
6892	1515	24	2	0	26	2	0.07692307692307693
6893	1483	33	0	0	33	0	0
6894	1517	30	2	0	32	2	0.0625
6895	1500	23	1	0	24	1	0.041666666666666664
6896	1518	23	2	0	25	2	0.08
6897	1527	31	0	0	31	0	0
6898	1522	31	1	0	32	1	0.03125
6899	1496	30	0	0	30	0	0
69	1505	29	0	0	29	0	0
690	1507	30	0	0	30	0	0
6900	1513	30	3	0	33	3	0.09090909090909091
6901	1514	34	0	0	34	0	0
6902	1519	27	0	0	27	0	0
6903	1500	35	0	0	35	0	0
6904	1516	28	0	0	28	0	0
6905	1519	25	3	0	28	3	0.10714285714285714
6906	1514	35	0	0	35	0	0
6907	1500	17	1	0	18	1	0.05555555555555555
6908	1517	30	1	0	31	1	0.03225806451612903
6909	1524	37	0	0	37	0	0
691	1515	29	1	0	30	1	0.03333333333333333
6910	1520	27	0	0	27	0	0
6911	1525	26	2	0	28	2	0.07142857142857142
6912	1503	21	1	0	22	1	0.045454545454545456
6913	1500	43	1	0	44	1	0.022727272727272728
6914	1528	33	1	0	34	1	0.029411764705882353
6915	1497	29	2	0	31	2	0.06451612903225806
6916	1497	32	2	0	34	2	0.058823529411764705
6917	1513	23	1	0	24	1	0.041666666666666664
6918	1514	23	1	0	24	1	0.041666666666666664
6919	1541	30	1	0	31	1	0.03225806451612903
692	1507	29	0	0	29	0	0
6920	1542	25	1	0	26	1	0.038461538461538464
6921	1478	36	3	0	39	3	0.07692307692307693
6922	1508	25	1	0	26	1	0.038461538461538464
6923	1496	32	0	0	32	0	0
6924	1506	40	1	0	41	1	0.024390243902439025
6925	1490	34	3	0	37	3	0.08108108108108109
6926	1534	27	1	0	28	1	0.03571428571428571
6927	1534	30	2	0	32	2	0.0625
6928	1529	32	1	0	33	1	0.030303030303030304
6929	1503	29	0	0	29	0	0
693	1505	26	0	0	26	0	0
6930	1553	29	0	0	29	0	0
6931	1501	34	1	0	35	1	0.02857142857142857
6932	1492	33	1	0	34	1	0.029411764705882353
6933	1484	38	2	0	40	2	0.05
6934	1536	29	0	0	29	0	0
6935	1504	25	0	0	25	0	0
6936	1534	25	2	1	28	3	0.10714285714285714
6937	1520	31	0	0	31	0	0
6938	1505	34	0	0	34	0	0
6939	1523	24	1	0	25	1	0.04
694	1511	34	0	0	34	0	0
6940	1508	37	2	0	39	2	0.05128205128205128
6941	1519	35	1	0	36	1	0.027777777777777776
6942	1527	27	0	0	27	0	0
6943	1495	35	1	0	36	1	0.027777777777777776
6944	1527	29	1	0	30	1	0.03333333333333333
6945	1520	37	0	0	37	0	0
6946	1535	38	0	0	38	0	0
6947	1508	29	1	0	30	1	0.03333333333333333
6948	1490	25	0	0	25	0	0
6949	1506	36	0	0	36	0	0
695	1526	25	3	0	28	3	0.10714285714285714
6950	1511	31	2	0	33	2	0.06060606060606061
6951	1490	35	1	0	36	1	0.027777777777777776
6952	1509	30	1	0	31	1	0.03225806451612903
6953	1484	30	2	0	32	2	0.0625
6954	1485	29	1	0	30	1	0.03333333333333333
6955	1520	31	0	0	31	0	0
6956	1501	30	0	0	30	0	0
6957	1507	30	1	0	31	1	0.03225806451612903
6958	1488	39	1	0	40	1	0.025
6959	1510	18	0	0	18	0	0
696	1514	27	0	0	27	0	0
6960	1534	33	0	0	33	0	0
6961	1507	26	2	0	28	2	0.07142857142857142
6962	1522	26	0	0	26	0	0
6963	1523	35	0	0	35	0	0
6964	1488	17	1	0	18	1	0.05555555555555555
6965	1546	25	1	0	26	1	0.038461538461538464
6966	1521	35	1	0	36	1	0.027777777777777776
6967	1535	34	0	0	34	0	0
6968	1487	33	1	0	34	1	0.029411764705882353
6969	1491	26	0	0	26	0	0
697	1522	29	0	0	29	0	0
6970	1514	25	0	0	25	0	0
6971	1501	27	1	0	28	1	0.03571428571428571
6972	1493	27	0	0	27	0	0
6973	1513	27	1	0	28	1	0.03571428571428571
6974	1499	36	1	0	37	1	0.02702702702702703
6975	1542	28	0	0	28	0	0
6976	1511	30	1	0	31	1	0.03225806451612903
6977	1511	27	3	0	30	3	0.1
6978	1491	31	0	0	31	0	0
6979	1551	21	1	0	22	1	0.045454545454545456
698	1519	30	1	0	31	1	0.03225806451612903
6980	1522	30	0	0	30	0	0
6981	1513	30	0	0	30	0	0
6982	1507	29	1	0	30	1	0.03333333333333333
6983	1498	28	1	0	29	1	0.034482758620689655
6984	1498	23	3	0	26	3	0.11538461538461539
6985	1505	27	1	0	28	1	0.03571428571428571
6986	1520	24	5	0	29	5	0.1724137931034483
6987	1481	30	1	0	31	1	0.03225806451612903
6988	1500	34	3	0	37	3	0.08108108108108109
6989	1519	29	1	0	30	1	0.03333333333333333
699	1524	23	0	0	23	0	0
6990	1545	40	2	0	42	2	0.047619047619047616
6991	1509	31	2	0	33	2	0.06060606060606061
6992	1536	26	0	0	26	0	0
6993	1523	25	1	0	26	1	0.038461538461538464
6994	1503	29	1	0	30	1	0.03333333333333333
6995	1531	36	0	0	36	0	0
6996	1520	15	1	0	16	1	0.0625
6997	1514	30	0	0	30	0	0
6998	1499	25	1	0	26	1	0.038461538461538464
6999	1490	32	1	0	33	1	0.030303030303030304
7	1505	23	1	0	24	1	0.041666666666666664
70	1519	32	1	0	33	1	0.030303030303030304
700	1502	29	1	0	30	1	0.03333333333333333
7000	1531	35	0	0	35	0	0
7001	1488	25	0	0	25	0	0
7002	1536	30	2	0	32	2	0.0625
7003	1488	33	1	0	34	1	0.029411764705882353
7004	1509	25	0	0	25	0	0
7005	1518	25	0	0	25	0	0
7006	1515	25	0	0	25	0	0
7007	1492	17	2	0	19	2	0.10526315789473684
7008	1491	26	0	0	26	0	0
7009	1498	22	1	0	23	1	0.043478260869565216
701	1534	34	0	0	34	0	0
7010	1529	25	2	0	27	2	0.07407407407407407
7011	1505	32	0	0	32	0	0
7012	1542	23	0	0	23	0	0
7013	1500	29	1	0	30	1	0.03333333333333333
7014	1509	26	3	0	29	3	0.10344827586206896
7015	1503	44	0	0	44	0	0
7016	1519	39	2	0	41	2	0.04878048780487805
7017	1504	34	0	0	34	0	0
7018	1522	28	1	0	29	1	0.034482758620689655
7019	1479	27	3	0	30	3	0.1
702	1504	42	1	0	43	1	0.023255813953488372
7020	1515	32	1	0	33	1	0.030303030303030304
7021	1510	29	0	0	29	0	0
7022	1489	29	0	0	29	0	0
7023	1489	27	0	0	27	0	0
7024	1524	31	1	0	32	1	0.03125
7025	1526	26	0	0	26	0	0
7026	1528	28	0	0	28	0	0
7027	1520	22	2	0	24	2	0.08333333333333333
7028	1505	38	1	0	39	1	0.02564102564102564
7029	1490	32	1	0	33	1	0.030303030303030304
703	1509	38	1	0	39	1	0.02564102564102564
7030	1501	35	0	0	35	0	0
7031	1515	24	0	0	24	0	0
7032	1552	36	1	0	37	1	0.02702702702702703
7033	1512	27	1	0	28	1	0.03571428571428571
7034	1522	42	0	0	42	0	0
7035	1530	35	2	0	37	2	0.05405405405405406
7036	1509	25	0	0	25	0	0
7037	1547	23	2	0	25	2	0.08
7038	1531	32	1	0	33	1	0.030303030303030304
7039	1540	33	0	0	33	0	0
704	1498	35	2	0	37	2	0.05405405405405406
7040	1536	24	1	0	25	1	0.04
7041	1491	43	0	0	43	0	0
7042	1511	32	0	0	32	0	0
7043	1493	30	0	0	30	0	0
7044	1504	36	0	0	36	0	0
7045	1461	26	0	0	26	0	0
7046	1523	28	1	0	29	1	0.034482758620689655
7047	1495	39	6	0	45	6	0.13333333333333333
7048	1517	23	2	0	25	2	0.08
7049	1505	40	1	0	41	1	0.024390243902439025
705	1508	42	2	0	44	2	0.045454545454545456
7050	1533	42	1	0	43	1	0.023255813953488372
7051	1528	29	0	0	29	0	0
7052	1516	29	0	0	29	0	0
7053	1519	29	1	0	30	1	0.03333333333333333
7054	1495	27	1	0	28	1	0.03571428571428571
7055	1476	28	2	0	30	2	0.06666666666666667
7056	1506	27	0	1	28	1	0.03571428571428571
7057	1536	33	1	0	34	1	0.029411764705882353
7058	1519	36	0	0	36	0	0
7059	1526	21	1	1	23	2	0.08695652173913043
706	1529	37	1	0	38	1	0.02631578947368421
7060	1509	26	0	0	26	0	0
7061	1498	24	0	0	24	0	0
7062	1497	36	1	0	37	1	0.02702702702702703
7063	1505	31	0	0	31	0	0
7064	1516	26	0	0	26	0	0
7065	1536	35	1	0	36	1	0.027777777777777776
7066	1521	32	2	0	34	2	0.058823529411764705
7067	1513	26	1	0	27	1	0.037037037037037035
7068	1533	26	1	0	27	1	0.037037037037037035
7069	1543	34	0	0	34	0	0
707	1478	35	1	0	36	1	0.027777777777777776
7070	1513	21	2	1	24	3	0.125
7071	1473	32	2	0	34	2	0.058823529411764705
7072	1507	29	0	0	29	0	0
7073	1528	28	1	0	29	1	0.034482758620689655
7074	1492	33	1	0	34	1	0.029411764705882353
7075	1497	27	0	0	27	0	0
7076	1529	35	2	0	37	2	0.05405405405405406
7077	1497	26	0	0	26	0	0
7078	1506	30	2	0	32	2	0.0625
7079	1552	33	2	0	35	2	0.05714285714285714
708	1519	25	0	0	25	0	0
7080	1508	34	1	0	35	1	0.02857142857142857
7081	1513	31	1	0	32	1	0.03125
7082	1569	33	0	0	33	0	0
7083	1497	27	1	1	29	2	0.06896551724137931
7084	1504	30	1	0	31	1	0.03225806451612903
7085	1521	35	2	0	37	2	0.05405405405405406
7086	1480	22	0	0	22	0	0
7087	1546	30	0	0	30	0	0
7088	1523	30	0	0	30	0	0
7089	1498	20	0	0	20	0	0
709	1518	30	3	0	33	3	0.09090909090909091
7090	1509	30	0	0	30	0	0
7091	1482	27	0	0	27	0	0
7092	1497	36	0	0	36	0	0
7093	1512	23	1	0	24	1	0.041666666666666664
7094	1498	40	1	1	42	2	0.047619047619047616
7095	1488	27	1	0	28	1	0.03571428571428571
7096	1511	39	2	0	41	2	0.04878048780487805
7097	1578	27	1	0	28	1	0.03571428571428571
7098	1529	30	0	0	30	0	0
7099	1496	25	1	0	26	1	0.038461538461538464
71	1489	22	0	0	22	0	0
710	1518	26	0	0	26	0	0
7100	1532	30	1	0	31	1	0.03225806451612903
7101	1519	22	0	0	22	0	0
7102	1502	32	1	0	33	1	0.030303030303030304
7103	1516	24	2	0	26	2	0.07692307692307693
7104	1498	20	1	0	21	1	0.047619047619047616
7105	1513	34	1	0	35	1	0.02857142857142857
7106	1532	47	1	0	48	1	0.020833333333333332
7107	1530	29	0	0	29	0	0
7108	1507	25	0	0	25	0	0
7109	1482	25	1	0	26	1	0.038461538461538464
711	1506	36	2	0	38	2	0.05263157894736842
7110	1523	28	1	0	29	1	0.034482758620689655
7111	1522	25	1	0	26	1	0.038461538461538464
7112	1500	33	0	0	33	0	0
7113	1510	20	3	0	23	3	0.13043478260869565
7114	1509	40	0	0	40	0	0
7115	1521	30	0	0	30	0	0
7116	1509	25	0	0	25	0	0
7117	1510	39	0	0	39	0	0
7118	1514	22	1	0	23	1	0.043478260869565216
7119	1546	31	0	0	31	0	0
712	1513	25	0	0	25	0	0
7120	1544	27	0	0	27	0	0
7121	1512	25	1	0	26	1	0.038461538461538464
7122	1485	26	1	0	27	1	0.037037037037037035
7123	1542	25	1	0	26	1	0.038461538461538464
7124	1495	28	1	0	29	1	0.034482758620689655
7125	1519	35	1	0	36	1	0.027777777777777776
7126	1481	24	0	0	24	0	0
7127	1504	18	2	0	20	2	0.1
7128	1494	28	0	0	28	0	0
7129	1501	25	0	0	25	0	0
713	1495	37	1	0	38	1	0.02631578947368421
7130	1504	24	1	0	25	1	0.04
7131	1514	31	1	0	32	1	0.03125
7132	1488	29	0	0	29	0	0
7133	1522	32	1	0	33	1	0.030303030303030304
7134	1505	28	0	0	28	0	0
7135	1491	30	1	0	31	1	0.03225806451612903
7136	1518	31	1	0	32	1	0.03125
7137	1526	35	0	0	35	0	0
7138	1498	33	0	0	33	0	0
7139	1555	30	0	0	30	0	0
714	1519	34	1	0	35	1	0.02857142857142857
7140	1547	31	0	0	31	0	0
7141	1508	48	0	0	48	0	0
7142	1548	30	1	0	31	1	0.03225806451612903
7143	1495	23	1	0	24	1	0.041666666666666664
7144	1519	27	0	0	27	0	0
7145	1522	20	1	0	21	1	0.047619047619047616
7146	1481	29	0	0	29	0	0
7147	1510	26	1	0	27	1	0.037037037037037035
7148	1504	28	2	0	30	2	0.06666666666666667
7149	1530	30	1	0	31	1	0.03225806451612903
715	1496	38	1	0	39	1	0.02564102564102564
7150	1534	32	0	0	32	0	0
7151	1536	16	1	0	17	1	0.058823529411764705
7152	1501	35	0	0	35	0	0
7153	1496	44	0	0	44	0	0
7154	1495	28	3	0	31	3	0.0967741935483871
7155	1480	18	0	0	18	0	0
7156	1527	24	0	0	24	0	0
7157	1506	38	1	0	39	1	0.02564102564102564
7158	1511	25	2	0	27	2	0.07407407407407407
7159	1527	28	2	0	30	2	0.06666666666666667
716	1500	29	0	0	29	0	0
7160	1479	28	0	0	28	0	0
7161	1488	34	4	0	38	4	0.10526315789473684
7162	1513	17	3	0	20	3	0.15
7163	1493	26	0	1	27	1	0.037037037037037035
7164	1521	30	2	0	32	2	0.0625
7165	1544	25	1	0	26	1	0.038461538461538464
7166	1500	42	0	0	42	0	0
7167	1541	23	1	0	24	1	0.041666666666666664
7168	1510	37	0	0	37	0	0
7169	1531	28	2	0	30	2	0.06666666666666667
717	1522	31	2	0	33	2	0.06060606060606061
7170	1509	33	0	0	33	0	0
7171	1516	23	0	0	23	0	0
7172	1493	36	0	0	36	0	0
7173	1493	29	0	0	29	0	0
7174	1510	26	1	0	27	1	0.037037037037037035
7175	1540	45	1	0	46	1	0.021739130434782608
7176	1509	36	1	0	37	1	0.02702702702702703
7177	1538	33	2	0	35	2	0.05714285714285714
7178	1500	34	0	0	34	0	0
7179	1497	24	0	0	24	0	0
718	1516	25	1	0	26	1	0.038461538461538464
7180	1516	39	1	0	40	1	0.025
7181	1509	29	0	0	29	0	0
7182	1532	31	0	0	31	0	0
7183	1519	30	2	0	32	2	0.0625
7184	1525	32	1	0	33	1	0.030303030303030304
7185	1499	22	2	0	24	2	0.08333333333333333
7186	1528	22	0	0	22	0	0
7187	1508	32	0	1	33	1	0.030303030303030304
7188	1528	26	0	0	26	0	0
7189	1471	32	2	0	34	2	0.058823529411764705
719	1504	23	0	0	23	0	0
7190	1528	39	0	0	39	0	0
7191	1522	26	3	0	29	3	0.10344827586206896
7192	1522	34	1	0	35	1	0.02857142857142857
7193	1491	42	0	0	42	0	0
7194	1549	30	2	0	32	2	0.0625
7195	1492	28	0	0	28	0	0
7196	1514	30	2	0	32	2	0.0625
7197	1485	30	2	0	32	2	0.0625
7198	1479	31	1	0	32	1	0.03125
7199	1512	37	1	0	38	1	0.02631578947368421
72	1522	28	2	0	30	2	0.06666666666666667
720	1468	26	2	0	28	2	0.07142857142857142
7200	1514	35	1	0	36	1	0.027777777777777776
7201	1501	29	0	0	29	0	0
7202	1500	27	1	0	28	1	0.03571428571428571
7203	1531	29	1	0	30	1	0.03333333333333333
7204	1494	39	0	0	39	0	0
7205	1503	36	2	0	38	2	0.05263157894736842
7206	1504	43	5	0	48	5	0.10416666666666667
7207	1500	24	0	0	24	0	0
7208	1477	31	1	0	32	1	0.03125
7209	1519	34	1	0	35	1	0.02857142857142857
721	1510	28	1	0	29	1	0.034482758620689655
7210	1550	33	2	0	35	2	0.05714285714285714
7211	1558	31	0	0	31	0	0
7212	1501	23	1	0	24	1	0.041666666666666664
7213	1476	35	0	0	35	0	0
7214	1516	29	0	0	29	0	0
7215	1469	32	2	0	34	2	0.058823529411764705
7216	1516	25	1	0	26	1	0.038461538461538464
7217	1548	23	0	0	23	0	0
7218	1482	31	2	0	33	2	0.06060606060606061
7219	1478	36	0	0	36	0	0
722	1511	36	1	0	37	1	0.02702702702702703
7220	1544	31	2	0	33	2	0.06060606060606061
7221	1495	30	1	0	31	1	0.03225806451612903
7222	1455	35	2	0	37	2	0.05405405405405406
7223	1524	45	0	0	45	0	0
7224	1532	48	1	0	49	1	0.02040816326530612
7225	1496	22	0	0	22	0	0
7226	1523	24	1	0	25	1	0.04
7227	1516	28	2	0	30	2	0.06666666666666667
7228	1534	22	1	0	23	1	0.043478260869565216
7229	1503	27	3	0	30	3	0.1
723	1536	37	0	0	37	0	0
7230	1517	26	0	0	26	0	0
7231	1521	38	0	0	38	0	0
7232	1544	28	3	0	31	3	0.0967741935483871
7233	1506	28	0	0	28	0	0
7234	1511	29	1	0	30	1	0.03333333333333333
7235	1539	37	1	0	38	1	0.02631578947368421
7236	1489	35	1	0	36	1	0.027777777777777776
7237	1457	33	3	0	36	3	0.08333333333333333
7238	1494	17	0	0	17	0	0
7239	1526	29	0	0	29	0	0
724	1501	34	1	0	35	1	0.02857142857142857
7240	1532	34	2	0	36	2	0.05555555555555555
7241	1481	28	2	0	30	2	0.06666666666666667
7242	1530	33	3	0	36	3	0.08333333333333333
7243	1505	32	2	0	34	2	0.058823529411764705
7244	1529	18	0	0	18	0	0
7245	1506	27	0	0	27	0	0
7246	1521	19	0	0	19	0	0
7247	1505	23	0	0	23	0	0
7248	1517	41	2	0	43	2	0.046511627906976744
7249	1496	30	0	0	30	0	0
725	1512	37	0	0	37	0	0
7250	1538	25	0	0	25	0	0
7251	1519	35	0	0	35	0	0
7252	1531	34	2	0	36	2	0.05555555555555555
7253	1488	41	0	0	41	0	0
7254	1503	38	2	0	40	2	0.05
7255	1514	35	0	0	35	0	0
7256	1479	24	2	0	26	2	0.07692307692307693
7257	1516	30	0	0	30	0	0
7258	1512	38	2	0	40	2	0.05
7259	1521	40	1	0	41	1	0.024390243902439025
726	1484	34	1	0	35	1	0.02857142857142857
7260	1522	29	0	0	29	0	0
7261	1514	27	0	0	27	0	0
7262	1543	28	1	0	29	1	0.034482758620689655
7263	1521	39	0	0	39	0	0
7264	1492	33	2	0	35	2	0.05714285714285714
7265	1485	22	0	0	22	0	0
7266	1538	28	2	0	30	2	0.06666666666666667
7267	1538	32	2	0	34	2	0.058823529411764705
7268	1537	28	0	0	28	0	0
7269	1495	35	2	0	37	2	0.05405405405405406
727	1518	30	1	0	31	1	0.03225806451612903
7270	1520	36	0	0	36	0	0
7271	1493	21	1	0	22	1	0.045454545454545456
7272	1505	23	0	0	23	0	0
7273	1506	22	2	0	24	2	0.08333333333333333
7274	1472	34	0	0	34	0	0
7275	1542	27	0	0	27	0	0
7276	1492	31	0	0	31	0	0
7277	1529	28	1	0	29	1	0.034482758620689655
7278	1542	30	1	0	31	1	0.03225806451612903
7279	1506	30	2	0	32	2	0.0625
728	1479	27	2	0	29	2	0.06896551724137931
7280	1510	43	1	0	44	1	0.022727272727272728
7281	1496	34	1	0	35	1	0.02857142857142857
7282	1515	23	0	0	23	0	0
7283	1510	27	1	0	28	1	0.03571428571428571
7284	1486	30	1	0	31	1	0.03225806451612903
7285	1491	35	0	0	35	0	0
7286	1505	28	0	0	28	0	0
7287	1502	28	0	0	28	0	0
7288	1509	41	0	0	41	0	0
7289	1503	30	3	0	33	3	0.09090909090909091
729	1517	33	0	0	33	0	0
7290	1513	25	1	0	26	1	0.038461538461538464
7291	1497	35	0	0	35	0	0
7292	1501	32	0	0	32	0	0
7293	1517	30	5	0	35	5	0.14285714285714285
7294	1502	25	0	0	25	0	0
7295	1502	28	0	0	28	0	0
7296	1527	41	0	0	41	0	0
7297	1501	42	0	0	42	0	0
7298	1532	30	2	0	32	2	0.0625
7299	1481	24	1	0	25	1	0.04
73	1544	24	1	0	25	1	0.04
730	1500	32	0	0	32	0	0
7300	1472	23	1	0	24	1	0.041666666666666664
7301	1523	36	0	0	36	0	0
7302	1520	39	0	0	39	0	0
7303	1522	39	3	0	42	3	0.07142857142857142
7304	1511	22	1	0	23	1	0.043478260869565216
7305	1486	28	0	0	28	0	0
7306	1552	35	0	0	35	0	0
7307	1507	27	0	0	27	0	0
7308	1490	34	1	0	35	1	0.02857142857142857
7309	1471	27	2	0	29	2	0.06896551724137931
731	1519	29	2	0	31	2	0.06451612903225806
7310	1501	25	1	0	26	1	0.038461538461538464
7311	1502	29	1	0	30	1	0.03333333333333333
7312	1492	21	2	0	23	2	0.08695652173913043
7313	1484	32	1	0	33	1	0.030303030303030304
7314	1500	28	1	0	29	1	0.034482758620689655
7315	1482	26	1	0	27	1	0.037037037037037035
7316	1536	28	2	0	30	2	0.06666666666666667
7317	1496	29	0	0	29	0	0
7318	1506	26	0	0	26	0	0
7319	1524	34	1	0	35	1	0.02857142857142857
732	1509	35	0	0	35	0	0
7320	1522	29	1	0	30	1	0.03333333333333333
7321	1501	33	2	0	35	2	0.05714285714285714
7322	1516	43	0	0	43	0	0
7323	1525	31	1	0	32	1	0.03125
7324	1546	31	1	0	32	1	0.03125
7325	1539	22	1	0	23	1	0.043478260869565216
7326	1472	31	3	0	34	3	0.08823529411764706
7327	1523	38	0	1	39	1	0.02564102564102564
7328	1502	33	1	0	34	1	0.029411764705882353
7329	1517	23	1	0	24	1	0.041666666666666664
733	1471	25	0	0	25	0	0
7330	1517	41	2	0	43	2	0.046511627906976744
7331	1494	27	1	0	28	1	0.03571428571428571
7332	1521	25	3	0	28	3	0.10714285714285714
7333	1510	36	1	0	37	1	0.02702702702702703
7334	1524	32	0	0	32	0	0
7335	1531	26	0	0	26	0	0
7336	1546	30	0	0	30	0	0
7337	1506	29	0	0	29	0	0
7338	1526	23	2	0	25	2	0.08
7339	1538	32	1	0	33	1	0.030303030303030304
734	1500	34	2	0	36	2	0.05555555555555555
7340	1518	24	0	0	24	0	0
7341	1552	27	1	0	28	1	0.03571428571428571
7342	1506	33	1	0	34	1	0.029411764705882353
7343	1492	32	2	0	34	2	0.058823529411764705
7344	1546	24	2	0	26	2	0.07692307692307693
7345	1474	31	1	0	32	1	0.03125
7346	1483	26	0	0	26	0	0
7347	1516	27	1	0	28	1	0.03571428571428571
7348	1517	33	2	0	35	2	0.05714285714285714
7349	1478	32	1	0	33	1	0.030303030303030304
735	1521	31	3	0	34	3	0.08823529411764706
7350	1504	30	2	0	32	2	0.0625
7351	1501	32	2	0	34	2	0.058823529411764705
7352	1494	34	0	0	34	0	0
7353	1492	36	2	0	38	2	0.05263157894736842
7354	1494	31	0	0	31	0	0
7355	1506	25	2	0	27	2	0.07407407407407407
7356	1524	30	3	0	33	3	0.09090909090909091
7357	1508	37	1	0	38	1	0.02631578947368421
7358	1519	39	1	0	40	1	0.025
7359	1534	33	2	0	35	2	0.05714285714285714
736	1488	33	0	0	33	0	0
7360	1539	30	3	0	33	3	0.09090909090909091
7361	1493	27	0	0	27	0	0
7362	1515	32	1	0	33	1	0.030303030303030304
7363	1520	25	0	0	25	0	0
7364	1467	33	1	0	34	1	0.029411764705882353
7365	1514	19	2	0	21	2	0.09523809523809523
7366	1535	24	1	0	25	1	0.04
7367	1526	30	1	0	31	1	0.03225806451612903
7368	1507	34	2	0	36	2	0.05555555555555555
7369	1495	33	0	0	33	0	0
737	1530	38	0	0	38	0	0
7370	1492	33	0	0	33	0	0
7371	1516	40	3	0	43	3	0.06976744186046512
7372	1537	30	3	0	33	3	0.09090909090909091
7373	1502	23	0	0	23	0	0
7374	1529	31	1	1	33	2	0.06060606060606061
7375	1475	40	0	0	40	0	0
7376	1515	31	1	0	32	1	0.03125
7377	1542	42	2	0	44	2	0.045454545454545456
7378	1537	31	0	0	31	0	0
7379	1487	32	2	0	34	2	0.058823529411764705
738	1512	29	1	0	30	1	0.03333333333333333
7380	1512	33	2	0	35	2	0.05714285714285714
7381	1457	23	0	0	23	0	0
7382	1500	32	0	0	32	0	0
7383	1533	21	3	0	24	3	0.125
7384	1527	35	1	0	36	1	0.027777777777777776
7385	1520	28	0	0	28	0	0
7386	1523	31	0	0	31	0	0
7387	1513	31	2	0	33	2	0.06060606060606061
7388	1502	32	2	0	34	2	0.058823529411764705
7389	1541	25	1	0	26	1	0.038461538461538464
739	1522	34	2	0	36	2	0.05555555555555555
7390	1486	30	1	0	31	1	0.03225806451612903
7391	1527	26	0	0	26	0	0
7392	1535	20	0	0	20	0	0
7393	1513	26	2	0	28	2	0.07142857142857142
7394	1530	31	0	0	31	0	0
7395	1510	32	0	0	32	0	0
7396	1520	30	0	0	30	0	0
7397	1502	29	2	0	31	2	0.06451612903225806
7398	1504	29	1	0	30	1	0.03333333333333333
7399	1506	34	0	0	34	0	0
74	1483	29	1	0	30	1	0.03333333333333333
740	1506	31	0	0	31	0	0
7400	1511	34	0	0	34	0	0
7401	1518	29	1	0	30	1	0.03333333333333333
7402	1496	35	1	0	36	1	0.027777777777777776
7403	1506	22	2	0	24	2	0.08333333333333333
7404	1499	30	0	0	30	0	0
7405	1498	41	0	0	41	0	0
7406	1521	28	1	0	29	1	0.034482758620689655
7407	1534	33	0	0	33	0	0
7408	1483	22	3	0	25	3	0.12
7409	1505	28	1	0	29	1	0.034482758620689655
741	1492	34	1	0	35	1	0.02857142857142857
7410	1522	26	2	0	28	2	0.07142857142857142
7411	1533	28	1	0	29	1	0.034482758620689655
7412	1506	26	0	0	26	0	0
7413	1508	29	1	0	30	1	0.03333333333333333
7414	1519	34	0	0	34	0	0
7415	1512	32	1	0	33	1	0.030303030303030304
7416	1508	30	1	0	31	1	0.03225806451612903
7417	1526	28	3	0	31	3	0.0967741935483871
7418	1512	29	1	0	30	1	0.03333333333333333
7419	1533	26	0	0	26	0	0
742	1510	35	0	0	35	0	0
7420	1509	32	0	0	32	0	0
7421	1514	31	0	0	31	0	0
7422	1543	33	2	0	35	2	0.05714285714285714
7423	1499	33	2	0	35	2	0.05714285714285714
7424	1552	26	1	1	28	2	0.07142857142857142
7425	1518	23	0	0	23	0	0
7426	1505	30	0	0	30	0	0
7427	1507	41	1	0	42	1	0.023809523809523808
7428	1524	25	0	0	25	0	0
7429	1565	25	1	0	26	1	0.038461538461538464
743	1527	28	1	0	29	1	0.034482758620689655
7430	1507	27	0	0	27	0	0
7431	1518	31	1	0	32	1	0.03125
7432	1519	32	1	0	33	1	0.030303030303030304
7433	1521	34	1	0	35	1	0.02857142857142857
7434	1549	28	4	0	32	4	0.125
7435	1501	31	0	0	31	0	0
7436	1536	31	0	0	31	0	0
7437	1511	28	1	0	29	1	0.034482758620689655
7438	1530	28	1	0	29	1	0.034482758620689655
7439	1494	33	1	0	34	1	0.029411764705882353
744	1525	36	0	0	36	0	0
7440	1518	23	1	0	24	1	0.041666666666666664
7441	1545	35	0	0	35	0	0
7442	1528	32	0	0	32	0	0
7443	1533	25	0	0	25	0	0
7444	1497	32	1	0	33	1	0.030303030303030304
7445	1496	26	0	0	26	0	0
7446	1513	34	0	0	34	0	0
7447	1503	33	0	0	33	0	0
7448	1532	31	3	0	34	3	0.08823529411764706
7449	1512	37	0	0	37	0	0
745	1509	35	0	0	35	0	0
7450	1504	39	2	0	41	2	0.04878048780487805
7451	1482	28	1	0	29	1	0.034482758620689655
7452	1528	32	1	0	33	1	0.030303030303030304
7453	1513	23	1	0	24	1	0.041666666666666664
7454	1494	27	0	0	27	0	0
7455	1505	39	0	0	39	0	0
7456	1526	31	0	0	31	0	0
7457	1531	30	1	0	31	1	0.03225806451612903
7458	1485	34	0	0	34	0	0
7459	1514	20	0	0	20	0	0
746	1550	34	1	0	35	1	0.02857142857142857
7460	1533	38	2	0	40	2	0.05
7461	1520	34	2	0	36	2	0.05555555555555555
7462	1524	30	1	0	31	1	0.03225806451612903
7463	1516	28	0	0	28	0	0
7464	1496	32	1	0	33	1	0.030303030303030304
7465	1462	18	2	0	20	2	0.1
7466	1510	33	1	0	34	1	0.029411764705882353
7467	1530	25	0	0	25	0	0
7468	1543	24	0	0	24	0	0
7469	1510	25	1	0	26	1	0.038461538461538464
747	1507	29	1	0	30	1	0.03333333333333333
7470	1510	36	1	0	37	1	0.02702702702702703
7471	1513	40	2	0	42	2	0.047619047619047616
7472	1487	39	1	0	40	1	0.025
7473	1518	27	1	0	28	1	0.03571428571428571
7474	1516	34	0	0	34	0	0
7475	1529	39	0	0	39	0	0
7476	1492	43	2	0	45	2	0.044444444444444446
7477	1518	32	1	0	33	1	0.030303030303030304
7478	1494	32	2	0	34	2	0.058823529411764705
7479	1510	30	0	0	30	0	0
748	1543	31	1	0	32	1	0.03125
7480	1546	36	0	0	36	0	0
7481	1513	30	0	0	30	0	0
7482	1490	28	0	0	28	0	0
7483	1509	40	1	0	41	1	0.024390243902439025
7484	1547	35	2	0	37	2	0.05405405405405406
7485	1528	23	0	0	23	0	0
7486	1545	36	2	0	38	2	0.05263157894736842
7487	1525	36	1	0	37	1	0.02702702702702703
7488	1515	41	4	0	45	4	0.08888888888888889
7489	1534	27	1	0	28	1	0.03571428571428571
749	1482	39	0	0	39	0	0
7490	1530	33	0	0	33	0	0
7491	1527	25	1	0	26	1	0.038461538461538464
7492	1523	34	2	0	36	2	0.05555555555555555
7493	1531	31	0	0	31	0	0
7494	1475	36	1	0	37	1	0.02702702702702703
7495	1491	24	3	0	27	3	0.1111111111111111
7496	1507	22	0	0	22	0	0
7497	1485	30	0	0	30	0	0
7498	1496	29	0	0	29	0	0
7499	1493	25	2	0	27	2	0.07407407407407407
75	1478	35	0	0	35	0	0
750	1505	37	2	0	39	2	0.05128205128205128
7500	1490	21	1	0	22	1	0.045454545454545456
7501	1529	30	1	0	31	1	0.03225806451612903
7502	1531	27	0	0	27	0	0
7503	1525	22	1	0	23	1	0.043478260869565216
7504	1541	24	1	0	25	1	0.04
7505	1522	33	0	0	33	0	0
7506	1511	31	1	0	32	1	0.03125
7507	1506	29	1	0	30	1	0.03333333333333333
7508	1530	30	0	0	30	0	0
7509	1526	31	0	0	31	0	0
751	1497	27	0	0	27	0	0
7510	1528	30	1	0	31	1	0.03225806451612903
7511	1491	29	1	0	30	1	0.03333333333333333
7512	1520	25	0	0	25	0	0
7513	1486	35	0	0	35	0	0
7514	1508	32	1	0	33	1	0.030303030303030304
7515	1497	24	1	0	25	1	0.04
7516	1492	29	0	0	29	0	0
7517	1517	25	0	1	26	1	0.038461538461538464
7518	1540	27	0	0	27	0	0
7519	1495	23	1	0	24	1	0.041666666666666664
752	1520	29	0	0	29	0	0
7520	1518	34	0	0	34	0	0
7521	1497	30	2	0	32	2	0.0625
7522	1508	23	0	0	23	0	0
7523	1543	30	2	0	32	2	0.0625
7524	1535	32	0	0	32	0	0
7525	1522	30	1	0	31	1	0.03225806451612903
7526	1516	31	0	0	31	0	0
7527	1540	38	2	0	40	2	0.05
7528	1514	29	1	0	30	1	0.03333333333333333
7529	1535	27	0	0	27	0	0
753	1487	34	3	0	37	3	0.08108108108108109
7530	1513	25	1	0	26	1	0.038461538461538464
7531	1499	31	1	0	32	1	0.03125
7532	1491	28	1	0	29	1	0.034482758620689655
7533	1482	41	0	0	41	0	0
7534	1521	22	0	0	22	0	0
7535	1513	31	1	0	32	1	0.03125
7536	1499	29	0	0	29	0	0
7537	1504	27	0	0	27	0	0
7538	1551	41	1	0	42	1	0.023809523809523808
7539	1488	27	1	0	28	1	0.03571428571428571
754	1473	29	1	0	30	1	0.03333333333333333
7540	1504	29	2	0	31	2	0.06451612903225806
7541	1525	33	3	0	36	3	0.08333333333333333
7542	1537	37	0	0	37	0	0
7543	1511	30	0	0	30	0	0
7544	1494	39	0	1	40	1	0.025
7545	1537	26	0	0	26	0	0
7546	1503	20	2	0	22	2	0.09090909090909091
7547	1497	33	1	0	34	1	0.029411764705882353
7548	1537	21	1	0	22	1	0.045454545454545456
7549	1496	37	0	0	37	0	0
755	1517	24	3	0	27	3	0.1111111111111111
7550	1473	33	1	0	34	1	0.029411764705882353
7551	1538	31	0	0	31	0	0
7552	1540	26	1	0	27	1	0.037037037037037035
7553	1516	35	0	0	35	0	0
7554	1500	38	0	0	38	0	0
7555	1479	46	2	0	48	2	0.041666666666666664
7556	1497	37	1	0	38	1	0.02631578947368421
7557	1496	31	0	0	31	0	0
7558	1507	35	1	0	36	1	0.027777777777777776
7559	1541	25	2	0	27	2	0.07407407407407407
756	1510	31	0	0	31	0	0
7560	1526	26	1	0	27	1	0.037037037037037035
7561	1485	34	2	0	36	2	0.05555555555555555
7562	1506	35	3	0	38	3	0.07894736842105263
7563	1499	35	0	0	35	0	0
7564	1522	43	1	0	44	1	0.022727272727272728
7565	1528	28	1	0	29	1	0.034482758620689655
7566	1510	24	0	0	24	0	0
7567	1518	33	1	0	34	1	0.029411764705882353
7568	1536	31	2	0	33	2	0.06060606060606061
7569	1526	32	2	0	34	2	0.058823529411764705
757	1510	34	0	0	34	0	0
7570	1509	32	0	0	32	0	0
7571	1506	31	2	0	33	2	0.06060606060606061
7572	1508	37	2	0	39	2	0.05128205128205128
7573	1497	34	2	0	36	2	0.05555555555555555
7574	1498	32	0	0	32	0	0
7575	1524	34	1	0	35	1	0.02857142857142857
7576	1540	35	0	0	35	0	0
7577	1555	22	1	0	23	1	0.043478260869565216
7578	1523	29	1	0	30	1	0.03333333333333333
7579	1507	35	2	0	37	2	0.05405405405405406
758	1503	24	1	0	25	1	0.04
7580	1540	30	1	0	31	1	0.03225806451612903
7581	1484	27	0	0	27	0	0
7582	1498	31	3	0	34	3	0.08823529411764706
7583	1533	26	0	0	26	0	0
7584	1527	26	1	0	27	1	0.037037037037037035
7585	1533	32	0	0	32	0	0
7586	1537	41	1	0	42	1	0.023809523809523808
7587	1504	37	2	0	39	2	0.05128205128205128
7588	1531	19	0	0	19	0	0
7589	1548	31	1	0	32	1	0.03125
759	1522	32	0	0	32	0	0
7590	1519	32	1	0	33	1	0.030303030303030304
7591	1523	23	0	0	23	0	0
7592	1545	28	1	0	29	1	0.034482758620689655
7593	1505	36	1	0	37	1	0.02702702702702703
7594	1517	30	1	0	31	1	0.03225806451612903
7595	1545	36	0	0	36	0	0
7596	1518	21	2	0	23	2	0.08695652173913043
7597	1523	24	3	0	27	3	0.1111111111111111
7598	1483	18	1	0	19	1	0.05263157894736842
7599	1489	36	0	0	36	0	0
76	1513	39	0	0	39	0	0
760	1484	29	1	0	30	1	0.03333333333333333
7600	1535	34	0	0	34	0	0
7601	1521	31	1	0	32	1	0.03125
7602	1503	28	0	0	28	0	0
7603	1504	35	1	0	36	1	0.027777777777777776
7604	1521	30	3	0	33	3	0.09090909090909091
7605	1502	19	1	0	20	1	0.05
7606	1511	37	1	0	38	1	0.02631578947368421
7607	1495	34	1	0	35	1	0.02857142857142857
7608	1545	25	2	0	27	2	0.07407407407407407
7609	1493	42	0	0	42	0	0
761	1530	35	0	0	35	0	0
7610	1541	29	1	0	30	1	0.03333333333333333
7611	1484	24	1	0	25	1	0.04
7612	1521	28	2	0	30	2	0.06666666666666667
7613	1470	31	0	0	31	0	0
7614	1519	18	1	0	19	1	0.05263157894736842
7615	1496	27	1	0	28	1	0.03571428571428571
7616	1526	27	0	0	27	0	0
7617	1501	31	0	0	31	0	0
7618	1503	40	0	0	40	0	0
7619	1501	35	1	0	36	1	0.027777777777777776
762	1498	30	2	0	32	2	0.0625
7620	1543	43	0	0	43	0	0
7621	1505	23	3	0	26	3	0.11538461538461539
7622	1531	37	3	0	40	3	0.075
7623	1507	27	1	0	28	1	0.03571428571428571
7624	1505	36	1	0	37	1	0.02702702702702703
7625	1491	34	0	0	34	0	0
7626	1482	31	0	0	31	0	0
7627	1523	23	1	0	24	1	0.041666666666666664
7628	1525	36	1	0	37	1	0.02702702702702703
7629	1510	38	2	0	40	2	0.05
763	1498	36	3	0	39	3	0.07692307692307693
7630	1500	33	0	0	33	0	0
7631	1521	27	0	0	27	0	0
7632	1525	35	0	0	35	0	0
7633	1501	32	4	0	36	4	0.1111111111111111
7634	1513	36	0	0	36	0	0
7635	1515	36	0	0	36	0	0
7636	1509	23	2	0	25	2	0.08
7637	1498	34	1	0	35	1	0.02857142857142857
7638	1526	34	0	0	34	0	0
7639	1520	28	2	0	30	2	0.06666666666666667
764	1492	33	0	0	33	0	0
7640	1529	29	2	0	31	2	0.06451612903225806
7641	1508	21	1	0	22	1	0.045454545454545456
7642	1504	36	1	0	37	1	0.02702702702702703
7643	1516	35	1	0	36	1	0.027777777777777776
7644	1540	34	2	0	36	2	0.05555555555555555
7645	1524	28	2	0	30	2	0.06666666666666667
7646	1510	29	2	0	31	2	0.06451612903225806
7647	1550	29	0	0	29	0	0
7648	1489	32	2	0	34	2	0.058823529411764705
7649	1465	21	1	0	22	1	0.045454545454545456
765	1503	31	2	0	33	2	0.06060606060606061
7650	1532	36	0	0	36	0	0
7651	1533	23	1	0	24	1	0.041666666666666664
7652	1514	32	0	0	32	0	0
7653	1525	28	0	0	28	0	0
7654	1534	31	1	0	32	1	0.03125
7655	1552	38	0	0	38	0	0
7656	1516	36	1	1	38	2	0.05263157894736842
7657	1491	22	0	0	22	0	0
7658	1526	26	3	0	29	3	0.10344827586206896
7659	1500	32	2	0	34	2	0.058823529411764705
766	1503	29	2	0	31	2	0.06451612903225806
7660	1523	27	1	0	28	1	0.03571428571428571
7661	1495	25	0	0	25	0	0
7662	1500	25	1	0	26	1	0.038461538461538464
7663	1534	26	1	0	27	1	0.037037037037037035
7664	1504	27	1	0	28	1	0.03571428571428571
7665	1491	30	1	0	31	1	0.03225806451612903
7666	1530	24	0	0	24	0	0
7667	1521	21	1	1	23	2	0.08695652173913043
7668	1510	32	1	0	33	1	0.030303030303030304
7669	1542	23	1	0	24	1	0.041666666666666664
767	1484	40	0	0	40	0	0
7670	1503	30	0	0	30	0	0
7671	1496	26	2	0	28	2	0.07142857142857142
7672	1513	23	0	0	23	0	0
7673	1492	34	2	0	36	2	0.05555555555555555
7674	1483	24	0	0	24	0	0
7675	1512	31	0	0	31	0	0
7676	1494	31	1	0	32	1	0.03125
7677	1502	32	1	0	33	1	0.030303030303030304
7678	1523	26	0	0	26	0	0
7679	1524	27	1	0	28	1	0.03571428571428571
768	1526	27	1	0	28	1	0.03571428571428571
7680	1530	30	1	0	31	1	0.03225806451612903
7681	1493	29	0	0	29	0	0
7682	1471	30	0	0	30	0	0
7683	1515	24	1	0	25	1	0.04
7684	1518	36	0	0	36	0	0
7685	1525	29	1	0	30	1	0.03333333333333333
7686	1484	32	4	0	36	4	0.1111111111111111
7687	1507	25	2	0	27	2	0.07407407407407407
7688	1513	39	0	0	39	0	0
7689	1526	17	1	0	18	1	0.05555555555555555
769	1489	31	1	0	32	1	0.03125
7690	1562	35	0	0	35	0	0
7691	1513	20	2	0	22	2	0.09090909090909091
7692	1534	28	1	0	29	1	0.034482758620689655
7693	1494	37	0	0	37	0	0
7694	1545	28	1	0	29	1	0.034482758620689655
7695	1520	28	2	0	30	2	0.06666666666666667
7696	1535	28	0	0	28	0	0
7697	1499	31	1	0	32	1	0.03125
7698	1524	17	1	0	18	1	0.05555555555555555
7699	1514	38	1	0	39	1	0.02564102564102564
77	1504	24	3	0	27	3	0.1111111111111111
770	1532	36	0	0	36	0	0
7700	1494	27	1	0	28	1	0.03571428571428571
7701	1498	31	0	0	31	0	0
7702	1476	33	0	0	33	0	0
7703	1509	32	2	0	34	2	0.058823529411764705
7704	1503	27	1	0	28	1	0.03571428571428571
7705	1494	29	1	0	30	1	0.03333333333333333
7706	1466	25	0	0	25	0	0
7707	1522	35	0	0	35	0	0
7708	1499	33	1	0	34	1	0.029411764705882353
7709	1512	39	0	0	39	0	0
771	1529	40	1	0	41	1	0.024390243902439025
7710	1549	32	0	0	32	0	0
7711	1523	33	1	0	34	1	0.029411764705882353
7712	1521	29	1	0	30	1	0.03333333333333333
7713	1511	24	3	0	27	3	0.1111111111111111
7714	1506	34	1	0	35	1	0.02857142857142857
7715	1526	36	1	0	37	1	0.02702702702702703
7716	1505	31	0	0	31	0	0
7717	1509	25	2	0	27	2	0.07407407407407407
7718	1512	29	1	0	30	1	0.03333333333333333
7719	1473	30	1	0	31	1	0.03225806451612903
772	1528	31	0	0	31	0	0
7720	1546	19	1	0	20	1	0.05
7721	1502	28	0	0	28	0	0
7722	1502	33	0	0	33	0	0
7723	1520	26	1	0	27	1	0.037037037037037035
7724	1474	30	1	0	31	1	0.03225806451612903
7725	1512	41	2	0	43	2	0.046511627906976744
7726	1500	31	0	0	31	0	0
7727	1511	30	2	0	32	2	0.0625
7728	1529	27	1	0	28	1	0.03571428571428571
7729	1516	29	2	0	31	2	0.06451612903225806
773	1500	26	0	0	26	0	0
7730	1521	28	1	0	29	1	0.034482758620689655
7731	1498	32	1	0	33	1	0.030303030303030304
7732	1498	22	0	0	22	0	0
7733	1512	29	0	0	29	0	0
7734	1508	23	1	1	25	2	0.08
7735	1497	31	0	0	31	0	0
7736	1503	19	2	0	21	2	0.09523809523809523
7737	1495	36	2	0	38	2	0.05263157894736842
7738	1498	32	0	0	32	0	0
7739	1504	38	0	0	38	0	0
774	1523	42	0	0	42	0	0
7740	1489	42	1	0	43	1	0.023255813953488372
7741	1515	25	0	0	25	0	0
7742	1518	26	1	0	27	1	0.037037037037037035
7743	1545	25	0	0	25	0	0
7744	1481	33	1	0	34	1	0.029411764705882353
7745	1515	23	2	0	25	2	0.08
7746	1517	37	0	0	37	0	0
7747	1565	38	1	0	39	1	0.02564102564102564
7748	1536	30	1	0	31	1	0.03225806451612903
7749	1500	30	1	0	31	1	0.03225806451612903
775	1510	25	0	0	25	0	0
7750	1531	32	0	0	32	0	0
7751	1513	28	0	0	28	0	0
7752	1503	29	0	0	29	0	0
7753	1505	31	3	0	34	3	0.08823529411764706
7754	1524	29	0	0	29	0	0
7755	1502	29	0	0	29	0	0
7756	1481	27	1	0	28	1	0.03571428571428571
7757	1483	29	0	0	29	0	0
7758	1466	23	3	0	26	3	0.11538461538461539
7759	1520	28	2	0	30	2	0.06666666666666667
776	1538	22	0	0	22	0	0
7760	1525	23	0	0	23	0	0
7761	1517	39	1	0	40	1	0.025
7762	1519	25	0	0	25	0	0
7763	1521	30	1	1	32	2	0.0625
7764	1503	30	0	0	30	0	0
7765	1526	23	2	0	25	2	0.08
7766	1538	28	2	0	30	2	0.06666666666666667
7767	1503	21	0	0	21	0	0
7768	1484	34	0	0	34	0	0
7769	1513	36	0	0	36	0	0
777	1513	31	0	0	31	0	0
7770	1510	36	0	0	36	0	0
7771	1522	25	2	0	27	2	0.07407407407407407
7772	1546	34	1	0	35	1	0.02857142857142857
7773	1505	43	0	0	43	0	0
7774	1488	31	0	0	31	0	0
7775	1519	27	0	1	28	1	0.03571428571428571
7776	1509	25	1	0	26	1	0.038461538461538464
7777	1505	31	1	0	32	1	0.03125
7778	1492	39	1	0	40	1	0.025
7779	1491	32	0	0	32	0	0
778	1517	28	0	0	28	0	0
7780	1512	28	0	0	28	0	0
7781	1491	35	0	0	35	0	0
7782	1509	35	3	0	38	3	0.07894736842105263
7783	1529	35	1	0	36	1	0.027777777777777776
7784	1510	26	0	0	26	0	0
7785	1528	36	1	0	37	1	0.02702702702702703
7786	1486	28	2	0	30	2	0.06666666666666667
7787	1513	30	2	0	32	2	0.0625
7788	1516	40	0	0	40	0	0
7789	1520	27	2	0	29	2	0.06896551724137931
779	1547	31	1	0	32	1	0.03125
7790	1526	36	1	0	37	1	0.02702702702702703
7791	1492	22	0	0	22	0	0
7792	1469	31	1	0	32	1	0.03125
7793	1508	32	1	0	33	1	0.030303030303030304
7794	1544	28	1	0	29	1	0.034482758620689655
7795	1516	31	0	0	31	0	0
7796	1508	21	3	0	24	3	0.125
7797	1535	32	0	0	32	0	0
7798	1519	32	0	0	32	0	0
7799	1517	21	0	0	21	0	0
78	1510	32	0	0	32	0	0
780	1533	31	1	0	32	1	0.03125
7800	1511	30	1	0	31	1	0.03225806451612903
7801	1529	37	1	0	38	1	0.02631578947368421
7802	1530	24	0	0	24	0	0
7803	1509	23	1	0	24	1	0.041666666666666664
7804	1481	22	0	0	22	0	0
7805	1516	32	0	0	32	0	0
7806	1550	22	0	0	22	0	0
7807	1529	37	2	0	39	2	0.05128205128205128
7808	1510	33	0	0	33	0	0
7809	1509	28	1	0	29	1	0.034482758620689655
781	1503	29	1	0	30	1	0.03333333333333333
7810	1515	32	0	0	32	0	0
7811	1512	31	1	0	32	1	0.03125
7812	1508	27	0	0	27	0	0
7813	1537	35	2	0	37	2	0.05405405405405406
7814	1501	27	1	0	28	1	0.03571428571428571
7815	1532	32	2	0	34	2	0.058823529411764705
7816	1471	27	3	0	30	3	0.1
7817	1511	35	1	0	36	1	0.027777777777777776
7818	1480	26	0	0	26	0	0
7819	1513	26	2	0	28	2	0.07142857142857142
782	1480	33	0	0	33	0	0
7820	1518	25	2	0	27	2	0.07407407407407407
7821	1520	37	2	0	39	2	0.05128205128205128
7822	1521	29	0	0	29	0	0
7823	1546	31	2	0	33	2	0.06060606060606061
7824	1501	27	0	0	27	0	0
7825	1474	22	0	0	22	0	0
7826	1476	35	3	0	38	3	0.07894736842105263
7827	1496	28	0	0	28	0	0
7828	1537	37	1	0	38	1	0.02631578947368421
7829	1531	32	1	0	33	1	0.030303030303030304
783	1520	24	0	0	24	0	0
7830	1530	24	1	0	25	1	0.04
7831	1500	31	1	0	32	1	0.03125
7832	1522	29	1	0	30	1	0.03333333333333333
7833	1518	31	0	0	31	0	0
7834	1512	29	2	0	31	2	0.06451612903225806
7835	1551	24	0	0	24	0	0
7836	1510	34	0	0	34	0	0
7837	1487	29	0	0	29	0	0
7838	1499	38	2	0	40	2	0.05
7839	1510	37	0	0	37	0	0
784	1506	36	1	0	37	1	0.02702702702702703
7840	1510	26	0	0	26	0	0
7841	1514	29	0	0	29	0	0
7842	1522	33	1	0	34	1	0.029411764705882353
7843	1488	39	0	0	39	0	0
7844	1485	32	2	0	34	2	0.058823529411764705
7845	1520	31	2	0	33	2	0.06060606060606061
7846	1508	20	0	0	20	0	0
7847	1524	29	1	0	30	1	0.03333333333333333
7848	1510	32	1	0	33	1	0.030303030303030304
7849	1514	31	1	0	32	1	0.03125
785	1528	25	0	0	25	0	0
7850	1481	27	2	0	29	2	0.06896551724137931
7851	1509	28	0	0	28	0	0
7852	1494	27	2	0	29	2	0.06896551724137931
7853	1490	20	2	0	22	2	0.09090909090909091
7854	1523	23	0	0	23	0	0
7855	1511	36	0	0	36	0	0
7856	1520	26	0	0	26	0	0
7857	1537	27	3	0	30	3	0.1
7858	1505	32	0	0	32	0	0
7859	1544	33	0	0	33	0	0
786	1533	17	1	0	18	1	0.05555555555555555
7860	1494	32	1	0	33	1	0.030303030303030304
7861	1520	34	0	0	34	0	0
7862	1505	35	2	0	37	2	0.05405405405405406
7863	1515	21	1	0	22	1	0.045454545454545456
7864	1510	25	0	0	25	0	0
7865	1499	32	0	0	32	0	0
7866	1493	24	2	0	26	2	0.07692307692307693
7867	1531	26	2	0	28	2	0.07142857142857142
7868	1510	29	0	0	29	0	0
7869	1527	25	0	1	26	1	0.038461538461538464
787	1518	21	0	0	21	0	0
7870	1515	32	0	0	32	0	0
7871	1507	28	1	0	29	1	0.034482758620689655
7872	1499	30	1	0	31	1	0.03225806451612903
7873	1517	25	0	0	25	0	0
7874	1514	27	2	0	29	2	0.06896551724137931
7875	1457	30	1	0	31	1	0.03225806451612903
7876	1497	38	3	0	41	3	0.07317073170731707
7877	1503	31	1	0	32	1	0.03125
7878	1520	35	0	0	35	0	0
7879	1548	23	0	0	23	0	0
788	1519	25	0	0	25	0	0
7880	1505	28	2	0	30	2	0.06666666666666667
7881	1544	32	2	0	34	2	0.058823529411764705
7882	1551	30	1	0	31	1	0.03225806451612903
7883	1519	29	1	0	30	1	0.03333333333333333
7884	1515	34	1	0	35	1	0.02857142857142857
7885	1496	36	0	0	36	0	0
7886	1482	32	0	0	32	0	0
7887	1526	28	0	0	28	0	0
7888	1505	30	0	0	30	0	0
7889	1515	31	0	0	31	0	0
789	1527	36	0	0	36	0	0
7890	1505	38	0	0	38	0	0
7891	1461	32	0	0	32	0	0
7892	1527	25	3	0	28	3	0.10714285714285714
7893	1500	34	2	0	36	2	0.05555555555555555
7894	1487	31	0	0	31	0	0
7895	1541	33	2	0	35	2	0.05714285714285714
7896	1529	34	1	0	35	1	0.02857142857142857
7897	1507	40	2	0	42	2	0.047619047619047616
7898	1483	25	1	0	26	1	0.038461538461538464
7899	1502	27	1	0	28	1	0.03571428571428571
79	1496	36	2	0	38	2	0.05263157894736842
790	1489	22	1	0	23	1	0.043478260869565216
7900	1512	37	1	0	38	1	0.02631578947368421
7901	1498	43	1	0	44	1	0.022727272727272728
7902	1489	23	0	0	23	0	0
7903	1487	35	0	0	35	0	0
7904	1509	35	0	0	35	0	0
7905	1489	29	1	0	30	1	0.03333333333333333
7906	1531	33	1	0	34	1	0.029411764705882353
7907	1486	38	1	0	39	1	0.02564102564102564
7908	1513	32	0	0	32	0	0
7909	1499	30	2	0	32	2	0.0625
791	1506	31	1	0	32	1	0.03125
7910	1524	29	1	0	30	1	0.03333333333333333
7911	1470	30	1	0	31	1	0.03225806451612903
7912	1529	29	2	0	31	2	0.06451612903225806
7913	1525	32	1	0	33	1	0.030303030303030304
7914	1514	34	0	0	34	0	0
7915	1540	38	2	0	40	2	0.05
7916	1502	33	0	0	33	0	0
7917	1520	28	0	1	29	1	0.034482758620689655
7918	1490	35	1	0	36	1	0.027777777777777776
7919	1499	26	1	0	27	1	0.037037037037037035
792	1539	26	0	0	26	0	0
7920	1524	30	0	0	30	0	0
7921	1528	30	1	0	31	1	0.03225806451612903
7922	1485	26	0	0	26	0	0
7923	1497	27	1	0	28	1	0.03571428571428571
7924	1516	37	2	0	39	2	0.05128205128205128
7925	1515	47	0	0	47	0	0
7926	1529	31	0	0	31	0	0
7927	1531	38	1	0	39	1	0.02564102564102564
7928	1534	28	0	0	28	0	0
7929	1512	29	0	0	29	0	0
793	1514	33	0	0	33	0	0
7930	1510	35	3	0	38	3	0.07894736842105263
7931	1511	27	0	0	27	0	0
7932	1543	25	2	0	27	2	0.07407407407407407
7933	1511	38	0	0	38	0	0
7934	1487	28	0	0	28	0	0
7935	1478	26	1	0	27	1	0.037037037037037035
7936	1531	36	0	0	36	0	0
7937	1495	29	0	0	29	0	0
7938	1536	29	2	0	31	2	0.06451612903225806
7939	1516	26	0	0	26	0	0
794	1520	27	0	0	27	0	0
7940	1501	28	2	0	30	2	0.06666666666666667
7941	1525	26	0	0	26	0	0
7942	1537	25	0	0	25	0	0
7943	1519	21	0	0	21	0	0
7944	1498	29	0	0	29	0	0
7945	1529	33	0	0	33	0	0
7946	1557	23	0	0	23	0	0
7947	1512	43	2	0	45	2	0.044444444444444446
7948	1490	34	4	0	38	4	0.10526315789473684
7949	1523	41	3	0	44	3	0.06818181818181818
795	1504	33	2	0	35	2	0.05714285714285714
7950	1493	29	1	0	30	1	0.03333333333333333
7951	1538	35	0	0	35	0	0
7952	1500	31	0	0	31	0	0
7953	1522	34	1	0	35	1	0.02857142857142857
7954	1531	26	1	0	27	1	0.037037037037037035
7955	1510	35	1	0	36	1	0.027777777777777776
7956	1512	33	2	0	35	2	0.05714285714285714
7957	1510	31	2	0	33	2	0.06060606060606061
7958	1492	38	1	0	39	1	0.02564102564102564
7959	1525	33	1	0	34	1	0.029411764705882353
796	1507	32	0	0	32	0	0
7960	1531	23	1	0	24	1	0.041666666666666664
7961	1500	27	1	0	28	1	0.03571428571428571
7962	1506	35	3	0	38	3	0.07894736842105263
7963	1544	22	0	0	22	0	0
7964	1510	26	2	0	28	2	0.07142857142857142
7965	1490	37	1	0	38	1	0.02631578947368421
7966	1506	27	0	0	27	0	0
7967	1502	33	1	0	34	1	0.029411764705882353
7968	1538	29	2	0	31	2	0.06451612903225806
7969	1553	29	1	0	30	1	0.03333333333333333
797	1477	38	1	0	39	1	0.02564102564102564
7970	1513	30	2	0	32	2	0.0625
7971	1518	41	2	0	43	2	0.046511627906976744
7972	1522	27	0	0	27	0	0
7973	1500	24	1	0	25	1	0.04
7974	1523	27	3	0	30	3	0.1
7975	1533	39	1	0	40	1	0.025
7976	1526	30	2	0	32	2	0.0625
7977	1531	21	3	0	24	3	0.125
7978	1508	30	1	0	31	1	0.03225806451612903
7979	1532	29	0	0	29	0	0
798	1488	40	0	0	40	0	0
7980	1469	32	1	0	33	1	0.030303030303030304
7981	1506	35	2	0	37	2	0.05405405405405406
7982	1509	30	0	0	30	0	0
7983	1531	25	0	0	25	0	0
7984	1500	26	1	0	27	1	0.037037037037037035
7985	1511	27	1	0	28	1	0.03571428571428571
7986	1524	21	0	0	21	0	0
7987	1506	33	1	0	34	1	0.029411764705882353
7988	1510	33	0	0	33	0	0
7989	1485	25	1	0	26	1	0.038461538461538464
799	1486	27	0	0	27	0	0
7990	1495	33	0	0	33	0	0
7991	1500	26	0	0	26	0	0
7992	1464	33	0	0	33	0	0
7993	1532	28	1	0	29	1	0.034482758620689655
7994	1516	40	0	0	40	0	0
7995	1498	34	1	0	35	1	0.02857142857142857
7996	1465	26	1	0	27	1	0.037037037037037035
7997	1559	22	0	0	22	0	0
7998	1485	29	2	0	31	2	0.06451612903225806
7999	1497	25	1	0	26	1	0.038461538461538464
8	1521	31	2	0	33	2	0.06060606060606061
80	1520	23	1	0	24	1	0.041666666666666664
800	1498	26	0	0	26	0	0
8000	1532	26	0	0	26	0	0
8001	1511	25	2	0	27	2	0.07407407407407407
8002	1483	34	1	0	35	1	0.02857142857142857
8003	1539	27	0	0	27	0	0
8004	1491	35	0	0	35	0	0
8005	1517	28	1	0	29	1	0.034482758620689655
8006	1519	34	1	0	35	1	0.02857142857142857
8007	1519	25	0	0	25	0	0
8008	1521	28	1	0	29	1	0.034482758620689655
8009	1490	26	2	0	28	2	0.07142857142857142
801	1500	36	1	0	37	1	0.02702702702702703
8010	1511	40	0	0	40	0	0
8011	1500	34	0	0	34	0	0
8012	1474	23	0	0	23	0	0
8013	1520	30	3	0	33	3	0.09090909090909091
8014	1492	31	1	0	32	1	0.03125
8015	1533	29	2	0	31	2	0.06451612903225806
8016	1515	32	0	0	32	0	0
8017	1523	39	1	0	40	1	0.025
8018	1564	30	1	0	31	1	0.03225806451612903
8019	1545	26	0	0	26	0	0
802	1501	28	0	0	28	0	0
8020	1534	26	0	0	26	0	0
8021	1517	29	0	0	29	0	0
8022	1552	29	1	0	30	1	0.03333333333333333
8023	1531	26	0	0	26	0	0
8024	1550	36	1	0	37	1	0.02702702702702703
8025	1513	24	2	0	26	2	0.07692307692307693
8026	1471	26	1	0	27	1	0.037037037037037035
8027	1515	39	2	0	41	2	0.04878048780487805
8028	1502	16	2	0	18	2	0.1111111111111111
8029	1505	23	2	0	25	2	0.08
803	1518	35	1	0	36	1	0.027777777777777776
8030	1522	24	0	0	24	0	0
8031	1498	25	1	0	26	1	0.038461538461538464
8032	1556	31	0	0	31	0	0
8033	1536	23	1	1	25	2	0.08
8034	1514	28	0	0	28	0	0
8035	1484	30	3	0	33	3	0.09090909090909091
8036	1534	24	1	0	25	1	0.04
8037	1513	32	1	0	33	1	0.030303030303030304
8038	1507	27	1	0	28	1	0.03571428571428571
8039	1513	35	0	0	35	0	0
804	1502	39	2	0	41	2	0.04878048780487805
8040	1491	36	1	0	37	1	0.02702702702702703
8041	1533	34	0	0	34	0	0
8042	1479	30	1	0	31	1	0.03225806451612903
8043	1563	32	1	0	33	1	0.030303030303030304
8044	1537	31	0	0	31	0	0
8045	1521	32	1	0	33	1	0.030303030303030304
8046	1511	27	1	0	28	1	0.03571428571428571
8047	1524	32	0	0	32	0	0
8048	1487	26	3	0	29	3	0.10344827586206896
8049	1551	34	3	0	37	3	0.08108108108108109
805	1549	31	0	0	31	0	0
8050	1488	34	1	0	35	1	0.02857142857142857
8051	1506	26	3	0	29	3	0.10344827586206896
8052	1525	28	0	0	28	0	0
8053	1524	23	1	0	24	1	0.041666666666666664
8054	1529	29	1	0	30	1	0.03333333333333333
8055	1528	27	1	0	28	1	0.03571428571428571
8056	1499	33	3	0	36	3	0.08333333333333333
8057	1527	32	1	0	33	1	0.030303030303030304
8058	1512	27	1	0	28	1	0.03571428571428571
8059	1512	33	3	0	36	3	0.08333333333333333
806	1556	34	1	0	35	1	0.02857142857142857
8060	1467	22	0	0	22	0	0
8061	1494	28	3	0	31	3	0.0967741935483871
8062	1461	32	1	0	33	1	0.030303030303030304
8063	1516	27	0	0	27	0	0
8064	1492	31	0	0	31	0	0
8065	1518	34	2	0	36	2	0.05555555555555555
8066	1519	34	0	0	34	0	0
8067	1529	27	1	0	28	1	0.03571428571428571
8068	1524	29	2	0	31	2	0.06451612903225806
8069	1518	24	1	0	25	1	0.04
807	1519	35	1	0	36	1	0.027777777777777776
8070	1533	30	0	0	30	0	0
8071	1500	23	0	0	23	0	0
8072	1529	25	0	0	25	0	0
8073	1494	32	2	0	34	2	0.058823529411764705
8074	1502	29	1	0	30	1	0.03333333333333333
8075	1512	28	1	0	29	1	0.034482758620689655
8076	1489	20	2	0	22	2	0.09090909090909091
8077	1496	27	0	0	27	0	0
8078	1527	34	1	0	35	1	0.02857142857142857
8079	1516	27	3	0	30	3	0.1
808	1504	36	0	1	37	1	0.02702702702702703
8080	1512	34	2	0	36	2	0.05555555555555555
8081	1483	35	2	0	37	2	0.05405405405405406
8082	1494	30	0	0	30	0	0
8083	1497	36	1	0	37	1	0.02702702702702703
8084	1498	25	0	0	25	0	0
8085	1504	26	1	0	27	1	0.037037037037037035
8086	1527	24	1	0	25	1	0.04
8087	1507	29	0	0	29	0	0
8088	1504	23	4	0	27	4	0.14814814814814814
8089	1513	27	1	0	28	1	0.03571428571428571
809	1526	26	1	0	27	1	0.037037037037037035
8090	1546	21	0	0	21	0	0
8091	1548	20	1	0	21	1	0.047619047619047616
8092	1502	37	1	0	38	1	0.02631578947368421
8093	1497	46	2	0	48	2	0.041666666666666664
8094	1479	31	1	0	32	1	0.03125
8095	1533	30	2	0	32	2	0.0625
8096	1498	28	0	0	28	0	0
8097	1531	27	0	0	27	0	0
8098	1557	34	0	0	34	0	0
8099	1512	38	1	0	39	1	0.02564102564102564
81	1534	36	0	0	36	0	0
810	1490	29	1	0	30	1	0.03333333333333333
8100	1483	28	1	0	29	1	0.034482758620689655
8101	1529	26	0	0	26	0	0
8102	1465	46	1	0	47	1	0.02127659574468085
8103	1501	34	0	0	34	0	0
8104	1499	37	0	0	37	0	0
8105	1505	27	0	0	27	0	0
8106	1513	38	0	0	38	0	0
8107	1550	34	1	0	35	1	0.02857142857142857
8108	1502	19	0	0	19	0	0
8109	1538	27	0	0	27	0	0
811	1525	24	3	0	27	3	0.1111111111111111
8110	1518	31	2	0	33	2	0.06060606060606061
8111	1490	37	1	0	38	1	0.02631578947368421
8112	1512	31	1	0	32	1	0.03125
8113	1516	33	1	1	35	2	0.05714285714285714
8114	1535	33	0	0	33	0	0
8115	1540	43	0	0	43	0	0
8116	1517	24	0	0	24	0	0
8117	1498	24	2	0	26	2	0.07692307692307693
8118	1508	19	0	0	19	0	0
8119	1515	26	2	0	28	2	0.07142857142857142
812	1494	29	2	0	31	2	0.06451612903225806
8120	1480	28	1	0	29	1	0.034482758620689655
8121	1499	35	0	0	35	0	0
8122	1508	33	0	0	33	0	0
8123	1510	40	0	0	40	0	0
8124	1498	41	0	0	41	0	0
8125	1508	28	2	0	30	2	0.06666666666666667
8126	1516	34	3	0	37	3	0.08108108108108109
8127	1503	30	0	0	30	0	0
8128	1508	21	1	0	22	1	0.045454545454545456
8129	1553	34	0	0	34	0	0
813	1503	34	0	0	34	0	0
8130	1490	32	1	0	33	1	0.030303030303030304
8131	1530	34	0	0	34	0	0
8132	1521	28	1	0	29	1	0.034482758620689655
8133	1532	32	1	0	33	1	0.030303030303030304
8134	1545	33	1	0	34	1	0.029411764705882353
8135	1486	35	2	0	37	2	0.05405405405405406
8136	1481	33	0	0	33	0	0
8137	1522	28	1	0	29	1	0.034482758620689655
8138	1499	32	0	0	32	0	0
8139	1523	29	1	0	30	1	0.03333333333333333
814	1510	39	1	0	40	1	0.025
8140	1519	32	0	0	32	0	0
8141	1481	37	0	0	37	0	0
8142	1520	27	0	0	27	0	0
8143	1488	34	0	0	34	0	0
8144	1499	27	0	0	27	0	0
8145	1500	38	1	0	39	1	0.02564102564102564
8146	1494	24	1	0	25	1	0.04
8147	1498	26	3	0	29	3	0.10344827586206896
8148	1493	29	0	0	29	0	0
8149	1476	29	0	0	29	0	0
815	1520	36	0	0	36	0	0
8150	1516	27	1	0	28	1	0.03571428571428571
8151	1495	32	4	0	36	4	0.1111111111111111
8152	1503	27	0	0	27	0	0
8153	1504	33	0	0	33	0	0
8154	1508	30	0	0	30	0	0
8155	1535	33	1	0	34	1	0.029411764705882353
8156	1514	31	1	0	32	1	0.03125
8157	1553	26	1	0	27	1	0.037037037037037035
8158	1455	25	1	0	26	1	0.038461538461538464
8159	1508	38	4	0	42	4	0.09523809523809523
816	1473	28	1	0	29	1	0.034482758620689655
8160	1529	18	0	0	18	0	0
8161	1482	43	0	0	43	0	0
8162	1496	29	0	0	29	0	0
8163	1530	34	1	0	35	1	0.02857142857142857
8164	1516	24	0	0	24	0	0
8165	1517	27	0	0	27	0	0
8166	1522	23	1	0	24	1	0.041666666666666664
8167	1516	31	0	0	31	0	0
8168	1499	31	0	0	31	0	0
8169	1527	26	0	0	26	0	0
817	1524	31	1	0	32	1	0.03125
8170	1501	29	2	0	31	2	0.06451612903225806
8171	1507	34	0	0	34	0	0
8172	1528	30	2	0	32	2	0.0625
8173	1506	16	0	0	16	0	0
8174	1500	29	0	0	29	0	0
8175	1527	37	1	0	38	1	0.02631578947368421
8176	1534	26	2	0	28	2	0.07142857142857142
8177	1497	26	0	0	26	0	0
8178	1488	37	0	0	37	0	0
8179	1495	31	2	0	33	2	0.06060606060606061
818	1498	27	1	0	28	1	0.03571428571428571
8180	1477	25	2	0	27	2	0.07407407407407407
8181	1493	41	1	1	43	2	0.046511627906976744
8182	1508	32	0	0	32	0	0
8183	1512	24	0	0	24	0	0
8184	1485	36	0	0	36	0	0
8185	1503	26	1	0	27	1	0.037037037037037035
8186	1507	23	1	0	24	1	0.041666666666666664
8187	1515	45	2	0	47	2	0.0425531914893617
8188	1506	28	1	0	29	1	0.034482758620689655
8189	1490	33	1	0	34	1	0.029411764705882353
819	1501	35	2	0	37	2	0.05405405405405406
8190	1514	28	1	0	29	1	0.034482758620689655
8191	1538	22	2	0	24	2	0.08333333333333333
8192	1541	31	2	0	33	2	0.06060606060606061
8193	1521	23	0	0	23	0	0
8194	1509	30	0	0	30	0	0
8195	1508	28	3	0	31	3	0.0967741935483871
8196	1511	29	0	0	29	0	0
8197	1533	23	1	0	24	1	0.041666666666666664
8198	1496	25	2	0	27	2	0.07407407407407407
8199	1502	33	0	0	33	0	0
82	1482	23	1	0	24	1	0.041666666666666664
820	1526	40	2	0	42	2	0.047619047619047616
8200	1505	28	1	0	29	1	0.034482758620689655
8201	1513	40	3	0	43	3	0.06976744186046512
8202	1533	24	2	0	26	2	0.07692307692307693
8203	1523	23	2	0	25	2	0.08
8204	1506	31	2	0	33	2	0.06060606060606061
8205	1518	26	1	0	27	1	0.037037037037037035
8206	1522	24	1	0	25	1	0.04
8207	1504	30	1	0	31	1	0.03225806451612903
8208	1484	23	0	0	23	0	0
8209	1524	32	0	0	32	0	0
821	1528	35	2	0	37	2	0.05405405405405406
8210	1525	23	2	0	25	2	0.08
8211	1482	32	1	0	33	1	0.030303030303030304
8212	1493	32	0	0	32	0	0
8213	1518	23	2	0	25	2	0.08
8214	1525	31	1	1	33	2	0.06060606060606061
8215	1493	34	3	0	37	3	0.08108108108108109
8216	1475	33	2	0	35	2	0.05714285714285714
8217	1527	28	0	0	28	0	0
8218	1475	29	1	0	30	1	0.03333333333333333
8219	1509	32	0	0	32	0	0
822	1508	23	2	0	25	2	0.08
8220	1530	24	1	0	25	1	0.04
8221	1526	28	0	0	28	0	0
8222	1510	26	1	0	27	1	0.037037037037037035
8223	1539	32	1	0	33	1	0.030303030303030304
8224	1518	40	2	0	42	2	0.047619047619047616
8225	1521	29	0	0	29	0	0
8226	1553	42	1	0	43	1	0.023255813953488372
8227	1514	23	0	0	23	0	0
8228	1515	31	1	0	32	1	0.03125
8229	1498	28	0	0	28	0	0
823	1492	36	1	0	37	1	0.02702702702702703
8230	1516	34	0	0	34	0	0
8231	1479	26	1	0	27	1	0.037037037037037035
8232	1518	26	3	0	29	3	0.10344827586206896
8233	1517	30	0	0	30	0	0
8234	1519	30	1	0	31	1	0.03225806451612903
8235	1508	31	3	0	34	3	0.08823529411764706
8236	1545	26	0	0	26	0	0
8237	1509	33	0	0	33	0	0
8238	1527	30	0	0	30	0	0
8239	1514	28	0	0	28	0	0
824	1517	30	2	0	32	2	0.0625
8240	1544	32	1	0	33	1	0.030303030303030304
8241	1517	30	0	0	30	0	0
8242	1514	25	2	0	27	2	0.07407407407407407
8243	1520	28	0	0	28	0	0
8244	1515	26	1	0	27	1	0.037037037037037035
8245	1507	27	2	0	29	2	0.06896551724137931
8246	1494	23	1	0	24	1	0.041666666666666664
8247	1515	21	0	0	21	0	0
8248	1516	29	1	0	30	1	0.03333333333333333
8249	1518	23	0	0	23	0	0
825	1513	19	0	0	19	0	0
8250	1519	26	0	0	26	0	0
8251	1509	30	1	0	31	1	0.03225806451612903
8252	1524	43	0	0	43	0	0
8253	1504	21	1	0	22	1	0.045454545454545456
8254	1509	36	1	0	37	1	0.02702702702702703
8255	1527	30	1	0	31	1	0.03225806451612903
8256	1493	31	0	0	31	0	0
8257	1535	27	0	0	27	0	0
8258	1527	32	1	0	33	1	0.030303030303030304
8259	1495	30	3	0	33	3	0.09090909090909091
826	1482	32	1	0	33	1	0.030303030303030304
8260	1511	31	0	0	31	0	0
8261	1478	26	1	0	27	1	0.037037037037037035
8262	1524	32	2	0	34	2	0.058823529411764705
8263	1514	33	0	0	33	0	0
8264	1479	39	0	0	39	0	0
8265	1531	25	1	0	26	1	0.038461538461538464
8266	1524	26	1	0	27	1	0.037037037037037035
8267	1541	27	1	0	28	1	0.03571428571428571
8268	1511	27	0	0	27	0	0
8269	1527	37	0	0	37	0	0
827	1533	35	1	0	36	1	0.027777777777777776
8270	1500	48	1	0	49	1	0.02040816326530612
8271	1488	27	1	0	28	1	0.03571428571428571
8272	1513	37	1	0	38	1	0.02631578947368421
8273	1484	42	0	0	42	0	0
8274	1503	28	1	0	29	1	0.034482758620689655
8275	1496	36	0	0	36	0	0
8276	1521	34	0	0	34	0	0
8277	1520	27	0	0	27	0	0
8278	1523	39	2	0	41	2	0.04878048780487805
8279	1510	33	0	0	33	0	0
828	1502	39	0	0	39	0	0
8280	1534	29	1	0	30	1	0.03333333333333333
8281	1528	27	0	0	27	0	0
8282	1554	34	0	0	34	0	0
8283	1495	28	1	1	30	2	0.06666666666666667
8284	1493	35	1	0	36	1	0.027777777777777776
8285	1513	32	1	0	33	1	0.030303030303030304
8286	1537	38	3	0	41	3	0.07317073170731707
8287	1513	32	0	0	32	0	0
8288	1490	35	0	0	35	0	0
8289	1534	31	0	0	31	0	0
829	1493	27	0	0	27	0	0
8290	1520	18	0	0	18	0	0
8291	1497	27	1	0	28	1	0.03571428571428571
8292	1480	41	1	0	42	1	0.023809523809523808
8293	1526	25	0	0	25	0	0
8294	1539	23	0	0	23	0	0
8295	1508	31	0	0	31	0	0
8296	1521	20	2	0	22	2	0.09090909090909091
8297	1535	33	0	0	33	0	0
8298	1487	32	1	0	33	1	0.030303030303030304
8299	1520	26	0	0	26	0	0
83	1497	34	1	0	35	1	0.02857142857142857
830	1498	32	0	0	32	0	0
8300	1540	36	0	0	36	0	0
8301	1508	25	0	0	25	0	0
8302	1514	32	0	0	32	0	0
8303	1504	43	0	0	43	0	0
8304	1539	29	1	0	30	1	0.03333333333333333
8305	1505	33	0	0	33	0	0
8306	1515	36	0	1	37	1	0.02702702702702703
8307	1499	25	0	0	25	0	0
8308	1499	31	2	0	33	2	0.06060606060606061
8309	1507	32	0	0	32	0	0
831	1522	26	3	0	29	3	0.10344827586206896
8310	1527	29	0	0	29	0	0
8311	1533	38	1	0	39	1	0.02564102564102564
8312	1501	37	0	0	37	0	0
8313	1533	36	1	0	37	1	0.02702702702702703
8314	1490	36	0	0	36	0	0
8315	1519	39	2	0	41	2	0.04878048780487805
8316	1503	25	0	0	25	0	0
8317	1487	38	1	0	39	1	0.02564102564102564
8318	1509	25	1	0	26	1	0.038461538461538464
8319	1507	26	2	0	28	2	0.07142857142857142
832	1489	29	0	0	29	0	0
8320	1523	28	0	0	28	0	0
8321	1488	31	0	0	31	0	0
8322	1518	30	0	0	30	0	0
8323	1523	30	2	0	32	2	0.0625
8324	1552	30	0	0	30	0	0
8325	1497	31	0	0	31	0	0
8326	1493	26	1	0	27	1	0.037037037037037035
8327	1504	38	0	0	38	0	0
8328	1509	31	0	0	31	0	0
8329	1485	26	3	0	29	3	0.10344827586206896
833	1514	35	0	0	35	0	0
8330	1527	22	3	0	25	3	0.12
8331	1526	35	3	0	38	3	0.07894736842105263
8332	1476	23	2	0	25	2	0.08
8333	1490	27	0	0	27	0	0
8334	1489	35	0	0	35	0	0
8335	1481	27	1	0	28	1	0.03571428571428571
8336	1522	34	1	0	35	1	0.02857142857142857
8337	1479	27	1	0	28	1	0.03571428571428571
8338	1482	28	1	0	29	1	0.034482758620689655
8339	1495	33	2	0	35	2	0.05714285714285714
834	1533	24	0	1	25	1	0.04
8340	1486	27	1	0	28	1	0.03571428571428571
8341	1493	25	0	0	25	0	0
8342	1499	36	3	0	39	3	0.07692307692307693
8343	1494	34	2	0	36	2	0.05555555555555555
8344	1506	42	1	0	43	1	0.023255813953488372
8345	1530	27	2	0	29	2	0.06896551724137931
8346	1516	43	0	0	43	0	0
8347	1536	29	1	0	30	1	0.03333333333333333
8348	1529	18	0	0	18	0	0
8349	1499	26	0	0	26	0	0
835	1494	26	2	0	28	2	0.07142857142857142
8350	1511	36	3	0	39	3	0.07692307692307693
8351	1525	36	0	0	36	0	0
8352	1505	36	1	0	37	1	0.02702702702702703
8353	1504	22	0	0	22	0	0
8354	1518	33	0	0	33	0	0
8355	1533	24	2	0	26	2	0.07692307692307693
8356	1503	32	0	0	32	0	0
8357	1497	34	0	0	34	0	0
8358	1493	40	2	0	42	2	0.047619047619047616
8359	1511	28	2	0	30	2	0.06666666666666667
836	1515	35	2	0	37	2	0.05405405405405406
8360	1511	29	1	0	30	1	0.03333333333333333
8361	1493	26	0	0	26	0	0
8362	1495	38	0	0	38	0	0
8363	1496	19	0	0	19	0	0
8364	1529	31	0	1	32	1	0.03125
8365	1459	35	1	0	36	1	0.027777777777777776
8366	1481	29	1	0	30	1	0.03333333333333333
8367	1472	39	0	0	39	0	0
8368	1510	27	2	0	29	2	0.06896551724137931
8369	1511	36	1	0	37	1	0.02702702702702703
837	1450	37	1	0	38	1	0.02631578947368421
8370	1503	21	0	0	21	0	0
8371	1513	21	0	0	21	0	0
8372	1514	36	2	0	38	2	0.05263157894736842
8373	1507	29	0	0	29	0	0
8374	1539	27	0	0	27	0	0
8375	1521	32	1	0	33	1	0.030303030303030304
8376	1530	30	0	0	30	0	0
8377	1541	38	1	0	39	1	0.02564102564102564
8378	1492	26	1	0	27	1	0.037037037037037035
8379	1504	35	0	0	35	0	0
838	1468	31	0	0	31	0	0
8380	1495	28	0	0	28	0	0
8381	1533	31	0	0	31	0	0
8382	1524	28	2	0	30	2	0.06666666666666667
8383	1513	32	2	0	34	2	0.058823529411764705
8384	1497	22	1	0	23	1	0.043478260869565216
8385	1508	28	2	0	30	2	0.06666666666666667
8386	1511	26	0	0	26	0	0
8387	1511	27	1	0	28	1	0.03571428571428571
8388	1492	31	2	0	33	2	0.06060606060606061
8389	1518	25	2	0	27	2	0.07407407407407407
839	1489	42	1	0	43	1	0.023255813953488372
8390	1533	28	0	0	28	0	0
8391	1476	31	1	0	32	1	0.03125
8392	1502	41	0	0	41	0	0
8393	1479	32	0	0	32	0	0
8394	1525	34	0	0	34	0	0
8395	1484	35	1	0	36	1	0.027777777777777776
8396	1508	28	1	0	29	1	0.034482758620689655
8397	1553	33	1	0	34	1	0.029411764705882353
8398	1521	28	0	0	28	0	0
8399	1530	37	0	0	37	0	0
84	1480	31	1	0	32	1	0.03125
840	1525	30	1	0	31	1	0.03225806451612903
8400	1494	30	0	0	30	0	0
8401	1503	36	0	0	36	0	0
8402	1493	27	3	0	30	3	0.1
8403	1506	27	0	0	27	0	0
8404	1513	27	1	0	28	1	0.03571428571428571
8405	1492	36	1	0	37	1	0.02702702702702703
8406	1540	33	1	0	34	1	0.029411764705882353
8407	1529	32	0	0	32	0	0
8408	1542	37	4	0	41	4	0.0975609756097561
8409	1508	26	2	0	28	2	0.07142857142857142
841	1505	40	1	0	41	1	0.024390243902439025
8410	1507	33	1	0	34	1	0.029411764705882353
8411	1528	26	1	0	27	1	0.037037037037037035
8412	1495	20	1	0	21	1	0.047619047619047616
8413	1505	27	2	0	29	2	0.06896551724137931
8414	1520	28	0	0	28	0	0
8415	1514	27	0	0	27	0	0
8416	1506	39	0	0	39	0	0
8417	1491	28	1	0	29	1	0.034482758620689655
8418	1534	21	2	0	23	2	0.08695652173913043
8419	1513	26	2	0	28	2	0.07142857142857142
842	1508	30	2	0	32	2	0.0625
8420	1534	31	0	0	31	0	0
8421	1515	29	0	0	29	0	0
8422	1481	32	1	0	33	1	0.030303030303030304
8423	1556	34	0	0	34	0	0
8424	1501	34	1	1	36	2	0.05555555555555555
8425	1504	31	2	0	33	2	0.06060606060606061
8426	1516	24	1	0	25	1	0.04
8427	1526	33	0	0	33	0	0
8428	1486	31	1	0	32	1	0.03125
8429	1521	31	0	0	31	0	0
843	1448	31	0	0	31	0	0
8430	1493	34	1	0	35	1	0.02857142857142857
8431	1521	25	0	0	25	0	0
8432	1531	25	2	0	27	2	0.07407407407407407
8433	1523	26	1	0	27	1	0.037037037037037035
8434	1528	30	0	0	30	0	0
8435	1488	29	1	0	30	1	0.03333333333333333
8436	1515	32	1	0	33	1	0.030303030303030304
8437	1541	31	2	0	33	2	0.06060606060606061
8438	1520	25	0	0	25	0	0
8439	1501	30	1	0	31	1	0.03225806451612903
844	1535	27	1	0	28	1	0.03571428571428571
8440	1538	32	1	0	33	1	0.030303030303030304
8441	1495	22	1	0	23	1	0.043478260869565216
8442	1555	35	1	0	36	1	0.027777777777777776
8443	1531	37	1	0	38	1	0.02631578947368421
8444	1498	27	1	0	28	1	0.03571428571428571
8445	1520	27	1	0	28	1	0.03571428571428571
8446	1525	28	2	0	30	2	0.06666666666666667
8447	1509	32	0	0	32	0	0
8448	1500	27	0	0	27	0	0
8449	1550	31	0	0	31	0	0
845	1480	33	0	0	33	0	0
8450	1516	32	1	0	33	1	0.030303030303030304
8451	1506	33	0	0	33	0	0
8452	1514	27	2	0	29	2	0.06896551724137931
8453	1504	23	0	0	23	0	0
8454	1551	21	1	0	22	1	0.045454545454545456
8455	1476	30	0	0	30	0	0
8456	1519	28	1	0	29	1	0.034482758620689655
8457	1506	26	0	0	26	0	0
8458	1509	24	1	0	25	1	0.04
8459	1524	33	2	0	35	2	0.05714285714285714
846	1496	22	2	0	24	2	0.08333333333333333
8460	1512	35	0	0	35	0	0
8461	1508	23	0	0	23	0	0
8462	1501	42	2	0	44	2	0.045454545454545456
8463	1504	38	1	0	39	1	0.02564102564102564
8464	1527	25	2	0	27	2	0.07407407407407407
8465	1477	45	1	0	46	1	0.021739130434782608
8466	1520	35	1	0	36	1	0.027777777777777776
8467	1474	23	0	0	23	0	0
8468	1540	34	0	0	34	0	0
8469	1498	35	0	0	35	0	0
847	1551	34	0	0	34	0	0
8470	1479	36	3	0	39	3	0.07692307692307693
8471	1510	36	1	0	37	1	0.02702702702702703
8472	1516	32	2	0	34	2	0.058823529411764705
8473	1520	34	0	0	34	0	0
8474	1470	35	0	0	35	0	0
8475	1509	19	1	0	20	1	0.05
8476	1534	35	2	0	37	2	0.05405405405405406
8477	1523	31	1	0	32	1	0.03125
8478	1489	34	0	0	34	0	0
8479	1533	29	2	0	31	2	0.06451612903225806
848	1484	34	0	0	34	0	0
8480	1508	32	1	0	33	1	0.030303030303030304
8481	1530	31	1	0	32	1	0.03125
8482	1521	30	1	0	31	1	0.03225806451612903
8483	1498	25	3	0	28	3	0.10714285714285714
8484	1556	32	0	0	32	0	0
8485	1488	28	1	0	29	1	0.034482758620689655
8486	1522	26	1	0	27	1	0.037037037037037035
8487	1498	30	0	0	30	0	0
8488	1465	20	1	0	21	1	0.047619047619047616
8489	1535	26	1	0	27	1	0.037037037037037035
849	1482	39	0	0	39	0	0
8490	1548	32	0	0	32	0	0
8491	1515	34	2	0	36	2	0.05555555555555555
8492	1469	28	0	0	28	0	0
8493	1518	23	0	0	23	0	0
8494	1514	30	0	0	30	0	0
8495	1517	25	1	0	26	1	0.038461538461538464
8496	1491	38	1	0	39	1	0.02564102564102564
8497	1519	31	1	0	32	1	0.03125
8498	1538	20	0	0	20	0	0
8499	1512	24	1	0	25	1	0.04
85	1497	24	0	0	24	0	0
850	1506	31	0	0	31	0	0
8500	1518	37	0	0	37	0	0
8501	1545	30	2	0	32	2	0.0625
8502	1477	36	0	0	36	0	0
8503	1509	20	2	0	22	2	0.09090909090909091
8504	1483	30	0	0	30	0	0
8505	1511	25	0	0	25	0	0
8506	1489	32	1	0	33	1	0.030303030303030304
8507	1488	26	0	0	26	0	0
8508	1517	23	0	0	23	0	0
8509	1506	31	0	0	31	0	0
851	1499	25	1	0	26	1	0.038461538461538464
8510	1511	34	1	1	36	2	0.05555555555555555
8511	1536	30	1	0	31	1	0.03225806451612903
8512	1490	29	3	0	32	3	0.09375
8513	1473	34	1	0	35	1	0.02857142857142857
8514	1496	34	0	0	34	0	0
8515	1544	19	0	0	19	0	0
8516	1497	41	1	0	42	1	0.023809523809523808
8517	1506	31	1	0	32	1	0.03125
8518	1503	24	3	0	27	3	0.1111111111111111
8519	1543	33	0	0	33	0	0
852	1510	25	2	0	27	2	0.07407407407407407
8520	1500	36	2	0	38	2	0.05263157894736842
8521	1506	30	0	0	30	0	0
8522	1542	33	0	0	33	0	0
8523	1486	33	1	0	34	1	0.029411764705882353
8524	1467	30	0	0	30	0	0
8525	1506	31	0	0	31	0	0
8526	1526	26	1	0	27	1	0.037037037037037035
8527	1505	34	3	0	37	3	0.08108108108108109
8528	1512	19	2	0	21	2	0.09523809523809523
8529	1497	32	0	0	32	0	0
853	1550	29	2	0	31	2	0.06451612903225806
8530	1534	29	1	0	30	1	0.03333333333333333
8531	1511	23	3	0	26	3	0.11538461538461539
8532	1532	23	4	0	27	4	0.14814814814814814
8533	1503	30	0	0	30	0	0
8534	1485	36	0	0	36	0	0
8535	1504	29	1	0	30	1	0.03333333333333333
8536	1522	30	0	0	30	0	0
8537	1501	28	0	0	28	0	0
8538	1457	34	0	0	34	0	0
8539	1516	29	2	0	31	2	0.06451612903225806
854	1488	39	1	0	40	1	0.025
8540	1499	21	1	0	22	1	0.045454545454545456
8541	1530	23	0	0	23	0	0
8542	1511	30	2	0	32	2	0.0625
8543	1529	31	0	0	31	0	0
8544	1518	30	0	0	30	0	0
8545	1516	27	2	0	29	2	0.06896551724137931
8546	1505	30	0	0	30	0	0
8547	1507	38	0	0	38	0	0
8548	1548	28	0	0	28	0	0
8549	1523	36	2	0	38	2	0.05263157894736842
855	1503	36	0	0	36	0	0
8550	1495	27	4	0	31	4	0.12903225806451613
8551	1494	29	1	0	30	1	0.03333333333333333
8552	1528	33	0	0	33	0	0
8553	1489	28	0	0	28	0	0
8554	1522	31	0	0	31	0	0
8555	1513	37	2	0	39	2	0.05128205128205128
8556	1514	32	1	0	33	1	0.030303030303030304
8557	1518	29	0	0	29	0	0
8558	1493	31	1	0	32	1	0.03125
8559	1518	37	2	0	39	2	0.05128205128205128
856	1512	34	1	0	35	1	0.02857142857142857
8560	1522	32	2	0	34	2	0.058823529411764705
8561	1504	25	0	0	25	0	0
8562	1481	39	1	0	40	1	0.025
8563	1513	24	4	0	28	4	0.14285714285714285
8564	1503	30	1	0	31	1	0.03225806451612903
8565	1488	30	1	1	32	2	0.0625
8566	1529	29	1	0	30	1	0.03333333333333333
8567	1527	39	1	0	40	1	0.025
8568	1518	28	3	0	31	3	0.0967741935483871
8569	1513	35	0	0	35	0	0
857	1524	32	0	0	32	0	0
8570	1529	25	0	0	25	0	0
8571	1502	32	0	0	32	0	0
8572	1525	21	0	0	21	0	0
8573	1512	20	1	0	21	1	0.047619047619047616
8574	1506	28	1	0	29	1	0.034482758620689655
8575	1550	19	1	0	20	1	0.05
8576	1494	28	1	0	29	1	0.034482758620689655
8577	1503	26	3	0	29	3	0.10344827586206896
8578	1531	35	2	0	37	2	0.05405405405405406
8579	1462	39	1	0	40	1	0.025
858	1513	24	0	1	25	1	0.04
8580	1545	40	0	0	40	0	0
8581	1487	31	1	0	32	1	0.03125
8582	1534	28	1	0	29	1	0.034482758620689655
8583	1506	33	0	1	34	1	0.029411764705882353
8584	1536	25	0	0	25	0	0
8585	1496	27	0	0	27	0	0
8586	1517	33	1	0	34	1	0.029411764705882353
8587	1512	46	0	0	46	0	0
8588	1517	28	2	0	30	2	0.06666666666666667
8589	1533	33	0	0	33	0	0
859	1518	45	1	0	46	1	0.021739130434782608
8590	1544	33	1	0	34	1	0.029411764705882353
8591	1545	36	1	0	37	1	0.02702702702702703
8592	1513	26	1	0	27	1	0.037037037037037035
8593	1538	25	0	0	25	0	0
8594	1529	29	1	0	30	1	0.03333333333333333
8595	1474	26	1	0	27	1	0.037037037037037035
8596	1512	37	1	0	38	1	0.02631578947368421
8597	1511	30	1	0	31	1	0.03225806451612903
8598	1513	36	2	1	39	3	0.07692307692307693
8599	1508	36	0	0	36	0	0
86	1488	33	1	0	34	1	0.029411764705882353
860	1500	22	0	0	22	0	0
8600	1510	36	0	0	36	0	0
8601	1516	38	0	0	38	0	0
8602	1531	29	0	0	29	0	0
8603	1536	30	0	0	30	0	0
8604	1501	42	1	0	43	1	0.023255813953488372
8605	1493	27	3	0	30	3	0.1
8606	1486	30	0	0	30	0	0
8607	1533	33	0	0	33	0	0
8608	1525	23	0	0	23	0	0
8609	1500	33	2	0	35	2	0.05714285714285714
861	1513	38	0	0	38	0	0
8610	1507	14	0	0	14	0	0
8611	1508	27	3	0	30	3	0.1
8612	1500	31	0	0	31	0	0
8613	1538	21	0	0	21	0	0
8614	1499	37	0	0	37	0	0
8615	1524	26	0	0	26	0	0
8616	1496	36	1	0	37	1	0.02702702702702703
8617	1519	30	0	0	30	0	0
8618	1488	35	2	0	37	2	0.05405405405405406
8619	1504	28	0	0	28	0	0
862	1499	28	0	0	28	0	0
8620	1532	30	0	0	30	0	0
8621	1508	32	0	0	32	0	0
8622	1489	39	1	0	40	1	0.025
8623	1480	31	0	0	31	0	0
8624	1481	32	1	0	33	1	0.030303030303030304
8625	1503	23	2	0	25	2	0.08
8626	1546	32	0	0	32	0	0
8627	1476	34	3	0	37	3	0.08108108108108109
8628	1525	28	1	0	29	1	0.034482758620689655
8629	1507	35	1	0	36	1	0.027777777777777776
863	1507	28	0	0	28	0	0
8630	1539	29	0	0	29	0	0
8631	1514	36	1	0	37	1	0.02702702702702703
8632	1493	26	1	0	27	1	0.037037037037037035
8633	1496	34	0	0	34	0	0
8634	1522	35	1	0	36	1	0.027777777777777776
8635	1495	24	1	0	25	1	0.04
8636	1522	36	0	0	36	0	0
8637	1553	20	1	0	21	1	0.047619047619047616
8638	1471	32	0	0	32	0	0
8639	1516	27	0	0	27	0	0
864	1508	32	1	0	33	1	0.030303030303030304
8640	1533	31	0	0	31	0	0
8641	1525	37	0	1	38	1	0.02631578947368421
8642	1506	28	2	0	30	2	0.06666666666666667
8643	1505	23	0	0	23	0	0
8644	1523	30	1	0	31	1	0.03225806451612903
8645	1506	19	0	0	19	0	0
8646	1530	30	2	0	32	2	0.0625
8647	1506	26	1	0	27	1	0.037037037037037035
8648	1480	32	0	0	32	0	0
8649	1504	25	2	0	27	2	0.07407407407407407
865	1484	23	0	0	23	0	0
8650	1504	30	3	0	33	3	0.09090909090909091
8651	1501	24	1	0	25	1	0.04
8652	1541	28	0	0	28	0	0
8653	1508	34	2	0	36	2	0.05555555555555555
8654	1519	42	0	0	42	0	0
8655	1531	35	3	0	38	3	0.07894736842105263
8656	1488	34	1	0	35	1	0.02857142857142857
8657	1513	32	0	0	32	0	0
8658	1506	22	2	0	24	2	0.08333333333333333
8659	1506	21	0	0	21	0	0
866	1488	29	0	0	29	0	0
8660	1535	32	0	0	32	0	0
8661	1516	27	2	0	29	2	0.06896551724137931
8662	1509	33	1	0	34	1	0.029411764705882353
8663	1502	40	2	0	42	2	0.047619047619047616
8664	1525	31	1	0	32	1	0.03125
8665	1508	24	0	0	24	0	0
8666	1518	37	0	0	37	0	0
8667	1505	21	2	0	23	2	0.08695652173913043
8668	1532	27	0	0	27	0	0
8669	1527	30	1	0	31	1	0.03225806451612903
867	1519	24	0	0	24	0	0
8670	1499	24	0	0	24	0	0
8671	1541	25	1	0	26	1	0.038461538461538464
8672	1507	25	0	0	25	0	0
8673	1523	50	0	0	50	0	0
8674	1523	33	1	1	35	2	0.05714285714285714
8675	1488	24	1	0	25	1	0.04
8676	1463	28	0	0	28	0	0
8677	1512	31	0	1	32	1	0.03125
8678	1482	42	0	0	42	0	0
8679	1533	19	0	0	19	0	0
868	1510	26	0	0	26	0	0
8680	1477	31	0	0	31	0	0
8681	1504	24	2	0	26	2	0.07692307692307693
8682	1497	26	1	0	27	1	0.037037037037037035
8683	1537	26	1	0	27	1	0.037037037037037035
8684	1556	25	1	0	26	1	0.038461538461538464
8685	1544	23	0	0	23	0	0
8686	1508	32	0	0	32	0	0
8687	1514	25	0	0	25	0	0
8688	1503	16	2	0	18	2	0.1111111111111111
8689	1509	27	0	0	27	0	0
869	1543	35	2	0	37	2	0.05405405405405406
8690	1515	24	2	0	26	2	0.07692307692307693
8691	1528	28	0	0	28	0	0
8692	1516	24	2	0	26	2	0.07692307692307693
8693	1490	31	2	0	33	2	0.06060606060606061
8694	1477	34	0	0	34	0	0
8695	1502	34	2	0	36	2	0.05555555555555555
8696	1522	26	1	0	27	1	0.037037037037037035
8697	1524	29	0	0	29	0	0
8698	1500	28	0	0	28	0	0
8699	1539	28	0	0	28	0	0
87	1504	22	0	0	22	0	0
870	1477	26	2	0	28	2	0.07142857142857142
8700	1493	32	0	0	32	0	0
8701	1509	24	1	0	25	1	0.04
8702	1523	34	0	0	34	0	0
8703	1483	45	0	0	45	0	0
8704	1475	29	1	0	30	1	0.03333333333333333
8705	1520	26	1	0	27	1	0.037037037037037035
8706	1544	32	1	0	33	1	0.030303030303030304
8707	1476	32	1	0	33	1	0.030303030303030304
8708	1494	40	3	0	43	3	0.06976744186046512
8709	1511	31	0	0	31	0	0
871	1523	29	0	0	29	0	0
8710	1507	26	0	0	26	0	0
8711	1515	29	0	0	29	0	0
8712	1523	28	1	0	29	1	0.034482758620689655
8713	1509	34	2	0	36	2	0.05555555555555555
8714	1517	37	1	0	38	1	0.02631578947368421
8715	1521	31	0	0	31	0	0
8716	1524	28	1	0	29	1	0.034482758620689655
8717	1538	31	2	0	33	2	0.06060606060606061
8718	1502	38	3	1	42	4	0.09523809523809523
8719	1509	33	1	0	34	1	0.029411764705882353
872	1527	30	0	0	30	0	0
8720	1507	40	0	0	40	0	0
8721	1527	37	2	0	39	2	0.05128205128205128
8722	1492	32	1	0	33	1	0.030303030303030304
8723	1506	22	3	0	25	3	0.12
8724	1515	26	2	0	28	2	0.07142857142857142
8725	1560	32	0	0	32	0	0
8726	1500	26	0	0	26	0	0
8727	1526	35	1	0	36	1	0.027777777777777776
8728	1495	36	3	0	39	3	0.07692307692307693
8729	1484	30	2	0	32	2	0.0625
873	1506	21	0	0	21	0	0
8730	1538	33	0	0	33	0	0
8731	1476	24	0	0	24	0	0
8732	1541	35	2	0	37	2	0.05405405405405406
8733	1468	26	2	0	28	2	0.07142857142857142
8734	1480	33	1	0	34	1	0.029411764705882353
8735	1494	18	1	0	19	1	0.05263157894736842
8736	1501	22	0	0	22	0	0
8737	1541	27	1	0	28	1	0.03571428571428571
8738	1505	29	0	0	29	0	0
8739	1537	37	1	0	38	1	0.02631578947368421
874	1526	29	0	0	29	0	0
8740	1528	25	0	0	25	0	0
8741	1518	26	0	0	26	0	0
8742	1524	40	2	0	42	2	0.047619047619047616
8743	1550	23	0	0	23	0	0
8744	1509	33	1	0	34	1	0.029411764705882353
8745	1514	23	0	0	23	0	0
8746	1498	30	0	0	30	0	0
8747	1492	42	1	0	43	1	0.023255813953488372
8748	1505	33	1	0	34	1	0.029411764705882353
8749	1486	31	1	0	32	1	0.03125
875	1501	34	1	0	35	1	0.02857142857142857
8750	1500	22	0	0	22	0	0
8751	1487	27	2	1	30	3	0.1
8752	1554	21	2	0	23	2	0.08695652173913043
8753	1525	26	1	0	27	1	0.037037037037037035
8754	1506	40	2	0	42	2	0.047619047619047616
8755	1520	34	0	0	34	0	0
8756	1504	23	1	0	24	1	0.041666666666666664
8757	1514	24	1	0	25	1	0.04
8758	1499	30	2	0	32	2	0.0625
8759	1508	29	0	0	29	0	0
876	1476	29	0	0	29	0	0
8760	1522	35	0	0	35	0	0
8761	1490	31	1	0	32	1	0.03125
8762	1530	30	0	0	30	0	0
8763	1537	19	0	0	19	0	0
8764	1527	32	0	0	32	0	0
8765	1492	32	0	0	32	0	0
8766	1499	35	1	1	37	2	0.05405405405405406
8767	1531	22	1	0	23	1	0.043478260869565216
8768	1510	27	2	0	29	2	0.06896551724137931
8769	1502	37	1	0	38	1	0.02631578947368421
877	1493	26	0	0	26	0	0
8770	1543	28	0	0	28	0	0
8771	1513	26	0	0	26	0	0
8772	1552	32	2	0	34	2	0.058823529411764705
8773	1522	26	1	0	27	1	0.037037037037037035
8774	1507	27	1	0	28	1	0.03571428571428571
8775	1499	30	0	0	30	0	0
8776	1517	20	2	0	22	2	0.09090909090909091
8777	1520	36	0	0	36	0	0
8778	1497	32	0	0	32	0	0
8779	1504	28	0	0	28	0	0
878	1504	27	0	0	27	0	0
8780	1530	35	0	0	35	0	0
8781	1520	31	1	0	32	1	0.03125
8782	1521	22	0	0	22	0	0
8783	1502	27	1	0	28	1	0.03571428571428571
8784	1525	26	0	0	26	0	0
8785	1494	31	0	0	31	0	0
8786	1535	37	1	0	38	1	0.02631578947368421
8787	1478	33	2	0	35	2	0.05714285714285714
8788	1511	27	0	0	27	0	0
8789	1482	21	2	0	23	2	0.08695652173913043
879	1507	31	1	0	32	1	0.03125
8790	1486	32	1	0	33	1	0.030303030303030304
8791	1514	29	1	0	30	1	0.03333333333333333
8792	1489	28	0	0	28	0	0
8793	1517	28	1	0	29	1	0.034482758620689655
8794	1506	40	4	0	44	4	0.09090909090909091
8795	1511	32	1	0	33	1	0.030303030303030304
8796	1524	38	0	0	38	0	0
8797	1503	34	0	0	34	0	0
8798	1506	23	0	0	23	0	0
8799	1524	29	0	0	29	0	0
88	1509	41	0	0	41	0	0
880	1471	22	2	0	24	2	0.08333333333333333
8800	1468	30	1	0	31	1	0.03225806451612903
8801	1521	39	0	0	39	0	0
8802	1480	37	0	0	37	0	0
8803	1505	31	1	0	32	1	0.03125
8804	1525	34	1	0	35	1	0.02857142857142857
8805	1514	40	0	0	40	0	0
8806	1514	27	2	0	29	2	0.06896551724137931
8807	1503	25	1	0	26	1	0.038461538461538464
8808	1533	35	3	0	38	3	0.07894736842105263
8809	1526	32	2	0	34	2	0.058823529411764705
881	1485	35	0	0	35	0	0
8810	1498	36	2	0	38	2	0.05263157894736842
8811	1523	31	1	0	32	1	0.03125
8812	1516	32	2	0	34	2	0.058823529411764705
8813	1528	25	1	0	26	1	0.038461538461538464
8814	1478	39	0	0	39	0	0
8815	1515	42	0	0	42	0	0
8816	1498	31	0	0	31	0	0
8817	1501	32	0	0	32	0	0
8818	1497	35	0	0	35	0	0
8819	1549	31	1	0	32	1	0.03125
882	1513	36	1	0	37	1	0.02702702702702703
8820	1498	31	1	0	32	1	0.03125
8821	1517	41	3	0	44	3	0.06818181818181818
8822	1543	29	2	0	31	2	0.06451612903225806
8823	1525	25	1	0	26	1	0.038461538461538464
8824	1480	29	0	0	29	0	0
8825	1539	35	1	0	36	1	0.027777777777777776
8826	1511	35	0	0	35	0	0
8827	1502	31	0	0	31	0	0
8828	1494	30	0	0	30	0	0
8829	1511	23	1	0	24	1	0.041666666666666664
883	1518	30	1	0	31	1	0.03225806451612903
8830	1518	31	0	0	31	0	0
8831	1515	22	1	0	23	1	0.043478260869565216
8832	1512	33	0	0	33	0	0
8833	1500	34	1	0	35	1	0.02857142857142857
8834	1493	33	0	0	33	0	0
8835	1514	39	2	0	41	2	0.04878048780487805
8836	1480	29	0	0	29	0	0
8837	1522	26	2	0	28	2	0.07142857142857142
8838	1457	34	1	0	35	1	0.02857142857142857
8839	1511	26	1	0	27	1	0.037037037037037035
884	1530	20	1	0	21	1	0.047619047619047616
8840	1472	30	1	0	31	1	0.03225806451612903
8841	1492	32	0	0	32	0	0
8842	1543	22	1	0	23	1	0.043478260869565216
8843	1502	25	1	0	26	1	0.038461538461538464
8844	1543	28	1	0	29	1	0.034482758620689655
8845	1493	29	1	0	30	1	0.03333333333333333
8846	1508	22	0	0	22	0	0
8847	1511	30	2	0	32	2	0.0625
8848	1540	33	2	0	35	2	0.05714285714285714
8849	1507	29	0	0	29	0	0
885	1529	31	0	0	31	0	0
8850	1513	35	3	0	38	3	0.07894736842105263
8851	1513	32	0	0	32	0	0
8852	1521	29	1	0	30	1	0.03333333333333333
8853	1518	21	1	0	22	1	0.045454545454545456
8854	1533	30	3	0	33	3	0.09090909090909091
8855	1523	35	0	0	35	0	0
8856	1487	27	1	0	28	1	0.03571428571428571
8857	1518	30	1	0	31	1	0.03225806451612903
8858	1530	31	3	0	34	3	0.08823529411764706
8859	1489	36	1	0	37	1	0.02702702702702703
886	1507	32	1	0	33	1	0.030303030303030304
8860	1511	33	0	0	33	0	0
8861	1534	28	0	0	28	0	0
8862	1535	34	0	0	34	0	0
8863	1483	24	2	0	26	2	0.07692307692307693
8864	1485	23	0	0	23	0	0
8865	1499	35	1	0	36	1	0.027777777777777776
8866	1465	41	0	1	42	1	0.023809523809523808
8867	1500	30	2	0	32	2	0.0625
8868	1520	29	1	0	30	1	0.03333333333333333
8869	1513	34	1	0	35	1	0.02857142857142857
887	1537	22	1	0	23	1	0.043478260869565216
8870	1523	23	1	0	24	1	0.041666666666666664
8871	1500	36	2	0	38	2	0.05263157894736842
8872	1521	31	2	0	33	2	0.06060606060606061
8873	1497	32	1	0	33	1	0.030303030303030304
8874	1517	32	1	0	33	1	0.030303030303030304
8875	1499	30	1	0	31	1	0.03225806451612903
8876	1506	36	1	0	37	1	0.02702702702702703
8877	1495	18	0	0	18	0	0
8878	1513	30	2	0	32	2	0.0625
8879	1500	32	1	0	33	1	0.030303030303030304
888	1515	24	2	0	26	2	0.07692307692307693
8880	1512	42	1	0	43	1	0.023255813953488372
8881	1511	22	0	0	22	0	0
8882	1516	23	0	0	23	0	0
8883	1506	33	0	0	33	0	0
8884	1530	21	0	0	21	0	0
8885	1499	29	1	0	30	1	0.03333333333333333
8886	1500	37	0	0	37	0	0
8887	1526	25	0	0	25	0	0
8888	1503	42	0	0	42	0	0
8889	1549	32	0	0	32	0	0
889	1553	22	4	0	26	4	0.15384615384615385
8890	1506	22	0	0	22	0	0
8891	1547	34	0	0	34	0	0
8892	1514	24	2	0	26	2	0.07692307692307693
8893	1502	38	1	0	39	1	0.02564102564102564
8894	1531	30	1	0	31	1	0.03225806451612903
8895	1497	38	1	0	39	1	0.02564102564102564
8896	1492	37	2	0	39	2	0.05128205128205128
8897	1513	26	0	0	26	0	0
8898	1467	22	1	0	23	1	0.043478260869565216
8899	1523	37	1	0	38	1	0.02631578947368421
89	1513	27	1	0	28	1	0.03571428571428571
890	1469	20	0	0	20	0	0
8900	1529	31	2	0	33	2	0.06060606060606061
8901	1491	34	0	0	34	0	0
8902	1497	26	1	1	28	2	0.07142857142857142
8903	1524	20	0	0	20	0	0
8904	1515	30	0	0	30	0	0
8905	1540	25	1	0	26	1	0.038461538461538464
8906	1508	26	0	0	26	0	0
8907	1502	32	1	0	33	1	0.030303030303030304
8908	1511	32	0	0	32	0	0
8909	1498	35	2	0	37	2	0.05405405405405406
891	1502	26	1	0	27	1	0.037037037037037035
8910	1510	41	1	0	42	1	0.023809523809523808
8911	1540	35	0	0	35	0	0
8912	1492	25	1	0	26	1	0.038461538461538464
8913	1509	26	0	0	26	0	0
8914	1480	34	2	0	36	2	0.05555555555555555
8915	1528	27	2	0	29	2	0.06896551724137931
8916	1511	34	0	0	34	0	0
8917	1528	28	1	0	29	1	0.034482758620689655
8918	1549	27	0	0	27	0	0
8919	1523	33	1	0	34	1	0.029411764705882353
892	1521	31	1	1	33	2	0.06060606060606061
8920	1484	29	0	0	29	0	0
8921	1532	40	0	0	40	0	0
8922	1496	20	1	0	21	1	0.047619047619047616
8923	1522	23	3	0	26	3	0.11538461538461539
8924	1518	27	3	0	30	3	0.1
8925	1547	31	0	0	31	0	0
8926	1520	43	3	0	46	3	0.06521739130434782
8927	1523	34	1	0	35	1	0.02857142857142857
8928	1484	35	0	0	35	0	0
8929	1502	27	1	0	28	1	0.03571428571428571
893	1506	26	0	0	26	0	0
8930	1528	27	1	0	28	1	0.03571428571428571
8931	1518	28	1	0	29	1	0.034482758620689655
8932	1523	35	2	0	37	2	0.05405405405405406
8933	1555	23	0	0	23	0	0
8934	1480	27	0	0	27	0	0
8935	1459	38	0	0	38	0	0
8936	1527	37	0	0	37	0	0
8937	1522	26	1	0	27	1	0.037037037037037035
8938	1525	26	0	0	26	0	0
8939	1552	40	0	0	40	0	0
894	1501	21	0	0	21	0	0
8940	1519	25	0	0	25	0	0
8941	1515	38	2	0	40	2	0.05
8942	1524	27	0	0	27	0	0
8943	1507	33	0	0	33	0	0
8944	1485	24	2	0	26	2	0.07692307692307693
8945	1548	33	0	0	33	0	0
8946	1514	33	0	0	33	0	0
8947	1511	27	1	0	28	1	0.03571428571428571
8948	1519	30	0	0	30	0	0
8949	1508	37	1	0	38	1	0.02631578947368421
895	1529	34	1	0	35	1	0.02857142857142857
8950	1482	27	3	0	30	3	0.1
8951	1526	27	2	0	29	2	0.06896551724137931
8952	1507	32	1	0	33	1	0.030303030303030304
8953	1502	42	1	0	43	1	0.023255813953488372
8954	1521	32	2	0	34	2	0.058823529411764705
8955	1510	27	0	0	27	0	0
8956	1522	36	0	0	36	0	0
8957	1482	34	0	0	34	0	0
8958	1504	31	2	0	33	2	0.06060606060606061
8959	1502	31	1	0	32	1	0.03125
896	1498	29	0	0	29	0	0
8960	1512	30	0	0	30	0	0
8961	1495	34	1	0	35	1	0.02857142857142857
8962	1514	33	0	0	33	0	0
8963	1505	26	2	0	28	2	0.07142857142857142
8964	1515	32	0	0	32	0	0
8965	1557	35	1	0	36	1	0.027777777777777776
8966	1514	29	5	0	34	5	0.14705882352941177
8967	1502	31	0	0	31	0	0
8968	1511	35	1	0	36	1	0.027777777777777776
8969	1468	35	1	0	36	1	0.027777777777777776
897	1528	34	0	0	34	0	0
8970	1545	37	1	0	38	1	0.02631578947368421
8971	1506	26	0	0	26	0	0
8972	1516	32	2	0	34	2	0.058823529411764705
8973	1533	29	3	0	32	3	0.09375
8974	1501	25	1	0	26	1	0.038461538461538464
8975	1488	29	0	0	29	0	0
8976	1499	36	0	0	36	0	0
8977	1523	29	0	0	29	0	0
8978	1510	32	0	0	32	0	0
8979	1523	31	0	0	31	0	0
898	1502	27	0	0	27	0	0
8980	1513	38	0	0	38	0	0
8981	1507	19	1	0	20	1	0.05
8982	1482	27	0	0	27	0	0
8983	1519	32	0	0	32	0	0
8984	1537	31	1	0	32	1	0.03125
8985	1499	30	2	0	32	2	0.0625
8986	1464	32	2	0	34	2	0.058823529411764705
8987	1452	34	1	0	35	1	0.02857142857142857
8988	1506	35	0	0	35	0	0
8989	1486	37	1	0	38	1	0.02631578947368421
899	1498	25	2	0	27	2	0.07407407407407407
8990	1537	32	0	0	32	0	0
8991	1518	27	0	0	27	0	0
8992	1493	40	0	0	40	0	0
8993	1526	24	0	0	24	0	0
8994	1522	26	0	0	26	0	0
8995	1499	27	0	0	27	0	0
8996	1518	17	0	0	17	0	0
8997	1522	32	0	0	32	0	0
8998	1490	29	0	0	29	0	0
8999	1521	36	2	0	38	2	0.05263157894736842
9	1518	34	1	0	35	1	0.02857142857142857
90	1502	31	3	0	34	3	0.08823529411764706
900	1497	21	1	0	22	1	0.045454545454545456
9000	1522	24	1	0	25	1	0.04
9001	1501	26	1	0	27	1	0.037037037037037035
9002	1528	31	0	0	31	0	0
9003	1509	37	1	0	38	1	0.02631578947368421
9004	1511	26	1	0	27	1	0.037037037037037035
9005	1543	21	2	0	23	2	0.08695652173913043
9006	1522	25	1	0	26	1	0.038461538461538464
9007	1507	32	2	0	34	2	0.058823529411764705
9008	1508	28	2	0	30	2	0.06666666666666667
9009	1494	27	0	0	27	0	0
901	1498	28	2	0	30	2	0.06666666666666667
9010	1483	25	2	0	27	2	0.07407407407407407
9011	1486	39	0	0	39	0	0
9012	1508	33	2	0	35	2	0.05714285714285714
9013	1530	32	0	0	32	0	0
9014	1499	32	0	0	32	0	0
9015	1521	46	1	0	47	1	0.02127659574468085
9016	1503	26	0	0	26	0	0
9017	1537	20	0	0	20	0	0
9018	1546	29	0	0	29	0	0
9019	1506	29	1	0	30	1	0.03333333333333333
902	1500	28	2	0	30	2	0.06666666666666667
9020	1517	44	1	0	45	1	0.022222222222222223
9021	1512	27	1	0	28	1	0.03571428571428571
9022	1502	31	0	0	31	0	0
9023	1507	27	0	0	27	0	0
9024	1471	29	2	0	31	2	0.06451612903225806
9025	1538	29	0	0	29	0	0
9026	1544	31	1	0	32	1	0.03125
9027	1505	36	1	0	37	1	0.02702702702702703
9028	1531	35	1	0	36	1	0.027777777777777776
9029	1517	29	5	0	34	5	0.14705882352941177
903	1532	27	1	0	28	1	0.03571428571428571
9030	1486	28	0	0	28	0	0
9031	1529	24	1	0	25	1	0.04
9032	1547	27	0	0	27	0	0
9033	1513	22	0	0	22	0	0
9034	1534	28	2	0	30	2	0.06666666666666667
9035	1505	29	0	0	29	0	0
9036	1505	34	2	0	36	2	0.05555555555555555
9037	1500	39	0	0	39	0	0
9038	1522	26	2	0	28	2	0.07142857142857142
9039	1508	35	3	0	38	3	0.07894736842105263
904	1524	29	2	0	31	2	0.06451612903225806
9040	1519	25	3	0	28	3	0.10714285714285714
9041	1526	21	1	0	22	1	0.045454545454545456
9042	1493	37	0	0	37	0	0
9043	1523	28	3	0	31	3	0.0967741935483871
9044	1507	23	1	0	24	1	0.041666666666666664
9045	1512	20	1	0	21	1	0.047619047619047616
9046	1515	34	2	0	36	2	0.05555555555555555
9047	1513	31	5	0	36	5	0.1388888888888889
9048	1525	35	1	0	36	1	0.027777777777777776
9049	1531	34	3	0	37	3	0.08108108108108109
905	1506	19	1	0	20	1	0.05
9050	1494	25	1	0	26	1	0.038461538461538464
9051	1498	30	1	0	31	1	0.03225806451612903
9052	1499	24	2	0	26	2	0.07692307692307693
9053	1495	24	0	0	24	0	0
9054	1461	33	3	0	36	3	0.08333333333333333
9055	1536	31	1	0	32	1	0.03125
9056	1533	32	2	0	34	2	0.058823529411764705
9057	1520	25	2	0	27	2	0.07407407407407407
9058	1485	25	0	0	25	0	0
9059	1485	30	1	0	31	1	0.03225806451612903
906	1509	35	2	0	37	2	0.05405405405405406
9060	1501	35	1	0	36	1	0.027777777777777776
9061	1531	30	1	0	31	1	0.03225806451612903
9062	1516	34	0	0	34	0	0
9063	1504	34	1	0	35	1	0.02857142857142857
9064	1479	33	1	0	34	1	0.029411764705882353
9065	1521	30	0	0	30	0	0
9066	1506	27	0	0	27	0	0
9067	1557	30	0	0	30	0	0
9068	1534	26	1	0	27	1	0.037037037037037035
9069	1535	24	1	0	25	1	0.04
907	1518	28	1	0	29	1	0.034482758620689655
9070	1521	22	2	0	24	2	0.08333333333333333
9071	1523	40	1	0	41	1	0.024390243902439025
9072	1499	31	0	0	31	0	0
9073	1459	23	2	0	25	2	0.08
9074	1489	27	1	0	28	1	0.03571428571428571
9075	1494	25	0	0	25	0	0
9076	1503	33	0	0	33	0	0
9077	1525	29	0	0	29	0	0
9078	1513	37	1	0	38	1	0.02631578947368421
9079	1487	30	1	0	31	1	0.03225806451612903
908	1504	21	0	0	21	0	0
9080	1511	26	3	0	29	3	0.10344827586206896
9081	1526	23	1	0	24	1	0.041666666666666664
9082	1514	28	2	0	30	2	0.06666666666666667
9083	1509	30	2	0	32	2	0.0625
9084	1523	31	2	0	33	2	0.06060606060606061
9085	1494	36	0	0	36	0	0
9086	1534	30	3	0	33	3	0.09090909090909091
9087	1530	28	1	0	29	1	0.034482758620689655
9088	1512	31	1	0	32	1	0.03125
9089	1526	28	1	0	29	1	0.034482758620689655
909	1495	37	0	0	37	0	0
9090	1505	29	1	0	30	1	0.03333333333333333
9091	1498	32	2	0	34	2	0.058823529411764705
9092	1522	17	1	0	18	1	0.05555555555555555
9093	1507	21	0	0	21	0	0
9094	1543	28	3	0	31	3	0.0967741935483871
9095	1514	37	1	0	38	1	0.02631578947368421
9096	1553	37	1	0	38	1	0.02631578947368421
9097	1530	27	0	0	27	0	0
9098	1495	31	2	0	33	2	0.06060606060606061
9099	1497	37	2	0	39	2	0.05128205128205128
91	1502	36	2	0	38	2	0.05263157894736842
910	1508	33	3	0	36	3	0.08333333333333333
9100	1499	30	1	0	31	1	0.03225806451612903
9101	1515	34	1	0	35	1	0.02857142857142857
9102	1493	39	0	0	39	0	0
9103	1513	21	2	0	23	2	0.08695652173913043
9104	1542	23	0	0	23	0	0
9105	1493	25	0	0	25	0	0
9106	1523	35	2	0	37	2	0.05405405405405406
9107	1486	37	1	0	38	1	0.02631578947368421
9108	1500	38	1	0	39	1	0.02564102564102564
9109	1508	37	2	0	39	2	0.05128205128205128
911	1538	26	0	0	26	0	0
9110	1470	30	0	0	30	0	0
9111	1507	40	1	0	41	1	0.024390243902439025
9112	1507	31	0	0	31	0	0
9113	1470	35	2	0	37	2	0.05405405405405406
9114	1501	33	2	0	35	2	0.05714285714285714
9115	1503	28	0	0	28	0	0
9116	1527	26	0	0	26	0	0
9117	1537	32	0	0	32	0	0
9118	1528	33	1	0	34	1	0.029411764705882353
9119	1499	24	2	0	26	2	0.07692307692307693
912	1531	29	0	0	29	0	0
9120	1495	23	0	0	23	0	0
9121	1523	30	1	0	31	1	0.03225806451612903
9122	1501	33	1	0	34	1	0.029411764705882353
9123	1526	37	3	0	40	3	0.075
9124	1514	33	0	0	33	0	0
9125	1526	34	0	0	34	0	0
9126	1511	23	2	0	25	2	0.08
9127	1472	37	1	0	38	1	0.02631578947368421
9128	1524	27	0	0	27	0	0
9129	1486	19	4	1	24	5	0.20833333333333334
913	1514	35	3	0	38	3	0.07894736842105263
9130	1527	37	2	0	39	2	0.05128205128205128
9131	1538	28	0	0	28	0	0
9132	1514	24	0	0	24	0	0
9133	1533	44	2	0	46	2	0.043478260869565216
9134	1494	23	1	0	24	1	0.041666666666666664
9135	1508	36	1	0	37	1	0.02702702702702703
9136	1509	28	4	0	32	4	0.125
9137	1533	26	1	0	27	1	0.037037037037037035
9138	1494	30	0	0	30	0	0
9139	1516	33	0	0	33	0	0
914	1498	33	2	0	35	2	0.05714285714285714
9140	1504	27	0	0	27	0	0
9141	1513	37	1	0	38	1	0.02631578947368421
9142	1511	31	3	0	34	3	0.08823529411764706
9143	1488	40	3	0	43	3	0.06976744186046512
9144	1479	39	0	0	39	0	0
9145	1522	30	1	0	31	1	0.03225806451612903
9146	1527	30	0	0	30	0	0
9147	1541	22	1	0	23	1	0.043478260869565216
9148	1511	34	1	0	35	1	0.02857142857142857
9149	1521	38	1	0	39	1	0.02564102564102564
915	1524	37	1	0	38	1	0.02631578947368421
9150	1503	35	0	0	35	0	0
9151	1494	36	0	0	36	0	0
9152	1514	23	0	0	23	0	0
9153	1540	27	0	0	27	0	0
9154	1523	27	1	0	28	1	0.03571428571428571
9155	1499	36	1	0	37	1	0.02702702702702703
9156	1514	28	2	0	30	2	0.06666666666666667
9157	1507	29	0	0	29	0	0
9158	1495	29	1	0	30	1	0.03333333333333333
9159	1541	26	2	0	28	2	0.07142857142857142
916	1509	34	1	0	35	1	0.02857142857142857
9160	1498	36	0	0	36	0	0
9161	1485	35	1	0	36	1	0.027777777777777776
9162	1535	21	1	0	22	1	0.045454545454545456
9163	1520	33	1	0	34	1	0.029411764705882353
9164	1515	26	1	0	27	1	0.037037037037037035
9165	1522	34	0	0	34	0	0
9166	1473	39	0	0	39	0	0
9167	1507	25	1	0	26	1	0.038461538461538464
9168	1515	25	2	0	27	2	0.07407407407407407
9169	1523	32	2	0	34	2	0.058823529411764705
917	1529	27	1	0	28	1	0.03571428571428571
9170	1505	28	1	0	29	1	0.034482758620689655
9171	1508	32	0	0	32	0	0
9172	1502	30	2	0	32	2	0.0625
9173	1499	27	1	0	28	1	0.03571428571428571
9174	1530	28	2	0	30	2	0.06666666666666667
9175	1524	35	0	0	35	0	0
9176	1519	27	1	0	28	1	0.03571428571428571
9177	1532	33	0	0	33	0	0
9178	1513	23	0	0	23	0	0
9179	1522	22	1	0	23	1	0.043478260869565216
918	1509	28	1	0	29	1	0.034482758620689655
9180	1516	34	2	0	36	2	0.05555555555555555
9181	1540	28	0	0	28	0	0
9182	1536	36	0	0	36	0	0
9183	1527	32	1	0	33	1	0.030303030303030304
9184	1499	28	2	0	30	2	0.06666666666666667
9185	1530	27	0	0	27	0	0
9186	1523	29	0	0	29	0	0
9187	1519	39	1	0	40	1	0.025
9188	1514	29	1	0	30	1	0.03333333333333333
9189	1499	30	0	0	30	0	0
919	1502	34	2	0	36	2	0.05555555555555555
9190	1507	25	1	0	26	1	0.038461538461538464
9191	1500	37	0	0	37	0	0
9192	1483	25	0	0	25	0	0
9193	1517	29	3	0	32	3	0.09375
9194	1556	29	0	0	29	0	0
9195	1529	28	2	0	30	2	0.06666666666666667
9196	1487	30	2	0	32	2	0.0625
9197	1517	19	0	0	19	0	0
9198	1508	41	1	0	42	1	0.023809523809523808
9199	1522	34	0	0	34	0	0
92	1505	29	0	0	29	0	0
920	1515	23	0	0	23	0	0
9200	1526	26	0	0	26	0	0
9201	1485	26	0	0	26	0	0
9202	1534	19	1	0	20	1	0.05
9203	1550	26	0	0	26	0	0
9204	1489	26	0	0	26	0	0
9205	1516	24	0	0	24	0	0
9206	1509	19	0	0	19	0	0
9207	1516	33	1	0	34	1	0.029411764705882353
9208	1470	24	1	0	25	1	0.04
9209	1502	28	2	0	30	2	0.06666666666666667
921	1526	29	1	0	30	1	0.03333333333333333
9210	1518	26	3	0	29	3	0.10344827586206896
9211	1519	34	0	0	34	0	0
9212	1528	21	0	0	21	0	0
9213	1547	35	0	0	35	0	0
9214	1499	27	1	0	28	1	0.03571428571428571
9215	1523	32	0	0	32	0	0
9216	1513	25	1	0	26	1	0.038461538461538464
9217	1520	28	0	0	28	0	0
9218	1500	28	3	0	31	3	0.0967741935483871
9219	1483	39	0	0	39	0	0
922	1524	23	0	0	23	0	0
9220	1521	31	0	0	31	0	0
9221	1509	35	1	1	37	2	0.05405405405405406
9222	1502	31	2	0	33	2	0.06060606060606061
9223	1534	22	0	0	22	0	0
9224	1516	29	0	0	29	0	0
9225	1519	32	0	0	32	0	0
9226	1482	26	1	0	27	1	0.037037037037037035
9227	1536	30	0	0	30	0	0
9228	1537	28	3	0	31	3	0.0967741935483871
9229	1520	33	4	0	37	4	0.10810810810810811
923	1530	20	0	0	20	0	0
9230	1543	32	0	0	32	0	0
9231	1526	27	3	0	30	3	0.1
9232	1481	38	0	0	38	0	0
9233	1539	35	2	0	37	2	0.05405405405405406
9234	1512	38	2	0	40	2	0.05
9235	1527	34	0	0	34	0	0
9236	1493	39	0	0	39	0	0
9237	1524	28	0	0	28	0	0
9238	1514	41	3	0	44	3	0.06818181818181818
9239	1483	33	0	1	34	1	0.029411764705882353
924	1514	26	3	0	29	3	0.10344827586206896
9240	1494	34	2	0	36	2	0.05555555555555555
9241	1527	32	1	0	33	1	0.030303030303030304
9242	1529	36	2	0	38	2	0.05263157894736842
9243	1486	29	2	0	31	2	0.06451612903225806
9244	1529	32	1	0	33	1	0.030303030303030304
9245	1537	29	1	0	30	1	0.03333333333333333
9246	1501	30	3	0	33	3	0.09090909090909091
9247	1504	26	0	0	26	0	0
9248	1516	44	0	0	44	0	0
9249	1514	22	2	0	24	2	0.08333333333333333
925	1502	31	0	0	31	0	0
9250	1499	30	2	0	32	2	0.0625
9251	1481	41	0	0	41	0	0
9252	1509	29	1	0	30	1	0.03333333333333333
9253	1528	27	0	0	27	0	0
9254	1508	33	1	0	34	1	0.029411764705882353
9255	1536	32	2	0	34	2	0.058823529411764705
9256	1542	30	0	0	30	0	0
9257	1496	25	0	0	25	0	0
9258	1533	32	4	0	36	4	0.1111111111111111
9259	1543	30	2	0	32	2	0.0625
926	1519	19	0	0	19	0	0
9260	1510	31	1	0	32	1	0.03125
9261	1520	30	0	0	30	0	0
9262	1517	30	0	0	30	0	0
9263	1529	29	0	0	29	0	0
9264	1507	33	1	0	34	1	0.029411764705882353
9265	1488	28	1	0	29	1	0.034482758620689655
9266	1517	35	1	0	36	1	0.027777777777777776
9267	1498	29	1	0	30	1	0.03333333333333333
9268	1523	36	2	0	38	2	0.05263157894736842
9269	1520	26	1	0	27	1	0.037037037037037035
927	1504	26	3	0	29	3	0.10344827586206896
9270	1536	29	0	0	29	0	0
9271	1501	31	0	0	31	0	0
9272	1481	32	1	0	33	1	0.030303030303030304
9273	1509	21	0	0	21	0	0
9274	1508	25	0	0	25	0	0
9275	1508	38	1	0	39	1	0.02564102564102564
9276	1518	32	1	0	33	1	0.030303030303030304
9277	1557	25	0	0	25	0	0
9278	1526	27	2	0	29	2	0.06896551724137931
9279	1512	37	1	0	38	1	0.02631578947368421
928	1507	20	0	0	20	0	0
9280	1486	41	1	0	42	1	0.023809523809523808
9281	1529	34	0	0	34	0	0
9282	1518	32	0	0	32	0	0
9283	1492	38	1	0	39	1	0.02564102564102564
9284	1522	35	3	0	38	3	0.07894736842105263
9285	1541	31	2	0	33	2	0.06060606060606061
9286	1512	27	0	1	28	1	0.03571428571428571
9287	1488	32	1	0	33	1	0.030303030303030304
9288	1535	18	3	0	21	3	0.14285714285714285
9289	1473	37	0	0	37	0	0
929	1532	24	1	0	25	1	0.04
9290	1502	29	1	0	30	1	0.03333333333333333
9291	1509	28	0	0	28	0	0
9292	1487	33	0	0	33	0	0
9293	1493	31	1	0	32	1	0.03125
9294	1519	24	0	0	24	0	0
9295	1498	28	0	0	28	0	0
9296	1535	28	0	0	28	0	0
9297	1493	28	1	0	29	1	0.034482758620689655
9298	1518	27	0	0	27	0	0
9299	1538	30	0	0	30	0	0
93	1546	29	2	0	31	2	0.06451612903225806
930	1530	31	3	0	34	3	0.08823529411764706
9300	1484	31	1	0	32	1	0.03125
9301	1510	27	1	0	28	1	0.03571428571428571
9302	1512	32	0	0	32	0	0
9303	1544	31	0	0	31	0	0
9304	1489	30	2	0	32	2	0.0625
9305	1513	27	0	0	27	0	0
9306	1534	25	0	0	25	0	0
9307	1548	34	1	0	35	1	0.02857142857142857
9308	1494	30	2	0	32	2	0.0625
9309	1546	26	1	0	27	1	0.037037037037037035
931	1481	30	0	0	30	0	0
9310	1514	20	1	0	21	1	0.047619047619047616
9311	1551	35	2	0	37	2	0.05405405405405406
9312	1506	32	0	0	32	0	0
9313	1481	44	0	0	44	0	0
9314	1519	35	0	0	35	0	0
9315	1519	29	0	0	29	0	0
9316	1526	31	0	0	31	0	0
9317	1512	27	0	0	27	0	0
9318	1480	29	0	0	29	0	0
9319	1482	29	1	0	30	1	0.03333333333333333
932	1493	29	1	0	30	1	0.03333333333333333
9320	1472	31	1	0	32	1	0.03125
9321	1508	34	1	0	35	1	0.02857142857142857
9322	1505	40	1	0	41	1	0.024390243902439025
9323	1510	28	4	0	32	4	0.125
9324	1489	27	0	0	27	0	0
9325	1526	25	1	0	26	1	0.038461538461538464
9326	1554	29	2	0	31	2	0.06451612903225806
9327	1505	26	1	0	27	1	0.037037037037037035
9328	1519	40	1	0	41	1	0.024390243902439025
9329	1522	31	0	0	31	0	0
933	1505	30	0	0	30	0	0
9330	1551	23	1	0	24	1	0.041666666666666664
9331	1498	21	0	0	21	0	0
9332	1507	29	1	0	30	1	0.03333333333333333
9333	1517	40	0	0	40	0	0
9334	1476	38	1	0	39	1	0.02564102564102564
9335	1536	25	1	0	26	1	0.038461538461538464
9336	1480	33	0	0	33	0	0
9337	1504	38	0	0	38	0	0
9338	1527	23	1	0	24	1	0.041666666666666664
9339	1512	23	3	0	26	3	0.11538461538461539
934	1485	25	0	0	25	0	0
9340	1486	26	1	0	27	1	0.037037037037037035
9341	1499	28	0	0	28	0	0
9342	1506	32	1	0	33	1	0.030303030303030304
9343	1543	28	1	0	29	1	0.034482758620689655
9344	1517	35	0	0	35	0	0
9345	1515	24	3	0	27	3	0.1111111111111111
9346	1520	38	2	0	40	2	0.05
9347	1501	27	1	0	28	1	0.03571428571428571
9348	1493	26	0	0	26	0	0
9349	1500	30	0	0	30	0	0
935	1511	27	0	0	27	0	0
9350	1502	35	0	0	35	0	0
9351	1531	30	1	0	31	1	0.03225806451612903
9352	1532	37	1	0	38	1	0.02631578947368421
9353	1521	29	1	0	30	1	0.03333333333333333
9354	1504	31	2	0	33	2	0.06060606060606061
9355	1504	33	0	0	33	0	0
9356	1534	27	2	0	29	2	0.06896551724137931
9357	1530	29	3	0	32	3	0.09375
9358	1482	26	1	0	27	1	0.037037037037037035
9359	1526	29	0	0	29	0	0
936	1488	32	2	0	34	2	0.058823529411764705
9360	1506	34	1	0	35	1	0.02857142857142857
9361	1489	28	1	0	29	1	0.034482758620689655
9362	1510	22	0	0	22	0	0
9363	1500	30	0	0	30	0	0
9364	1522	37	1	0	38	1	0.02631578947368421
9365	1518	27	1	0	28	1	0.03571428571428571
9366	1536	26	0	0	26	0	0
9367	1510	32	3	0	35	3	0.08571428571428572
9368	1499	31	3	0	34	3	0.08823529411764706
9369	1524	25	1	0	26	1	0.038461538461538464
937	1516	27	1	0	28	1	0.03571428571428571
9370	1470	33	0	0	33	0	0
9371	1507	33	1	0	34	1	0.029411764705882353
9372	1501	33	1	0	34	1	0.029411764705882353
9373	1508	39	1	0	40	1	0.025
9374	1543	30	1	0	31	1	0.03225806451612903
9375	1519	43	1	0	44	1	0.022727272727272728
9376	1539	26	1	0	27	1	0.037037037037037035
9377	1499	38	0	0	38	0	0
9378	1514	26	0	0	26	0	0
9379	1509	33	0	0	33	0	0
938	1522	23	1	0	24	1	0.041666666666666664
9380	1535	30	0	0	30	0	0
9381	1527	35	3	0	38	3	0.07894736842105263
9382	1501	34	1	0	35	1	0.02857142857142857
9383	1515	27	0	0	27	0	0
9384	1477	30	1	0	31	1	0.03225806451612903
9385	1515	33	2	0	35	2	0.05714285714285714
9386	1517	28	0	0	28	0	0
9387	1508	40	2	0	42	2	0.047619047619047616
9388	1501	36	1	0	37	1	0.02702702702702703
9389	1529	27	0	0	27	0	0
939	1507	33	2	0	35	2	0.05714285714285714
9390	1490	22	1	0	23	1	0.043478260869565216
9391	1509	28	0	0	28	0	0
9392	1528	31	0	0	31	0	0
9393	1496	30	1	0	31	1	0.03225806451612903
9394	1518	28	1	0	29	1	0.034482758620689655
9395	1536	31	0	0	31	0	0
9396	1506	34	3	0	37	3	0.08108108108108109
9397	1496	32	1	0	33	1	0.030303030303030304
9398	1524	24	2	0	26	2	0.07692307692307693
9399	1476	34	2	0	36	2	0.05555555555555555
94	1543	25	1	0	26	1	0.038461538461538464
940	1505	19	1	0	20	1	0.05
9400	1575	42	1	0	43	1	0.023255813953488372
9401	1548	23	0	0	23	0	0
9402	1483	28	1	0	29	1	0.034482758620689655
9403	1507	38	0	0	38	0	0
9404	1536	19	2	0	21	2	0.09523809523809523
9405	1511	26	3	0	29	3	0.10344827586206896
9406	1502	24	1	0	25	1	0.04
9407	1546	25	0	0	25	0	0
9408	1505	26	3	0	29	3	0.10344827586206896
9409	1498	23	0	0	23	0	0
941	1535	22	0	0	22	0	0
9410	1490	35	2	0	37	2	0.05405405405405406
9411	1496	33	0	0	33	0	0
9412	1533	24	0	0	24	0	0
9413	1541	19	1	0	20	1	0.05
9414	1508	30	2	0	32	2	0.0625
9415	1488	22	0	0	22	0	0
9416	1463	36	0	0	36	0	0
9417	1495	35	1	0	36	1	0.027777777777777776
9418	1488	24	0	0	24	0	0
9419	1470	28	2	1	31	3	0.0967741935483871
942	1525	34	0	0	34	0	0
9420	1517	26	0	0	26	0	0
9421	1542	26	2	0	28	2	0.07142857142857142
9422	1502	34	1	0	35	1	0.02857142857142857
9423	1510	34	1	0	35	1	0.02857142857142857
9424	1498	36	1	0	37	1	0.02702702702702703
9425	1504	42	2	0	44	2	0.045454545454545456
9426	1530	27	0	0	27	0	0
9427	1498	30	0	0	30	0	0
9428	1501	26	2	0	28	2	0.07142857142857142
9429	1533	28	0	0	28	0	0
943	1491	35	0	0	35	0	0
9430	1533	30	1	0	31	1	0.03225806451612903
9431	1522	34	0	0	34	0	0
9432	1516	32	0	0	32	0	0
9433	1513	23	3	0	26	3	0.11538461538461539
9434	1538	32	0	0	32	0	0
9435	1508	25	0	0	25	0	0
9436	1493	34	1	0	35	1	0.02857142857142857
9437	1494	29	0	0	29	0	0
9438	1497	30	1	0	31	1	0.03225806451612903
9439	1487	20	5	0	25	5	0.2
944	1523	16	1	0	17	1	0.058823529411764705
9440	1507	29	1	0	30	1	0.03333333333333333
9441	1537	35	0	0	35	0	0
9442	1502	24	0	0	24	0	0
9443	1513	26	2	0	28	2	0.07142857142857142
9444	1522	28	1	0	29	1	0.034482758620689655
9445	1507	32	3	0	35	3	0.08571428571428572
9446	1535	38	0	0	38	0	0
9447	1516	26	1	0	27	1	0.037037037037037035
9448	1526	35	1	0	36	1	0.027777777777777776
9449	1529	24	0	0	24	0	0
945	1545	30	1	0	31	1	0.03225806451612903
9450	1525	38	0	0	38	0	0
9451	1496	26	1	0	27	1	0.037037037037037035
9452	1507	25	2	0	27	2	0.07407407407407407
9453	1505	30	0	0	30	0	0
9454	1522	34	0	0	34	0	0
9455	1539	35	1	0	36	1	0.027777777777777776
9456	1531	32	1	0	33	1	0.030303030303030304
9457	1509	37	0	0	37	0	0
9458	1490	29	0	0	29	0	0
9459	1509	33	0	0	33	0	0
946	1494	28	1	0	29	1	0.034482758620689655
9460	1525	41	0	0	41	0	0
9461	1559	30	0	0	30	0	0
9462	1569	19	0	0	19	0	0
9463	1498	28	0	0	28	0	0
9464	1528	38	0	0	38	0	0
9465	1510	37	1	0	38	1	0.02631578947368421
9466	1476	33	1	0	34	1	0.029411764705882353
9467	1520	26	0	0	26	0	0
9468	1511	24	1	0	25	1	0.04
9469	1516	32	1	0	33	1	0.030303030303030304
947	1499	34	1	0	35	1	0.02857142857142857
9470	1512	25	0	0	25	0	0
9471	1512	25	0	0	25	0	0
9472	1490	30	2	0	32	2	0.0625
9473	1502	34	4	0	38	4	0.10526315789473684
9474	1507	34	0	0	34	0	0
9475	1508	27	0	0	27	0	0
9476	1506	36	2	0	38	2	0.05263157894736842
9477	1496	25	3	0	28	3	0.10714285714285714
9478	1510	34	2	0	36	2	0.05555555555555555
9479	1507	28	0	0	28	0	0
948	1506	34	2	0	36	2	0.05555555555555555
9480	1530	30	0	0	30	0	0
9481	1525	27	1	1	29	2	0.06896551724137931
9482	1496	33	0	0	33	0	0
9483	1513	30	2	0	32	2	0.0625
9484	1503	37	0	0	37	0	0
9485	1514	33	1	0	34	1	0.029411764705882353
9486	1522	29	0	0	29	0	0
9487	1504	29	2	0	31	2	0.06451612903225806
9488	1450	30	1	0	31	1	0.03225806451612903
9489	1528	31	1	0	32	1	0.03125
949	1510	33	0	0	33	0	0
9490	1501	31	2	0	33	2	0.06060606060606061
9491	1476	32	0	0	32	0	0
9492	1538	29	0	0	29	0	0
9493	1520	30	1	0	31	1	0.03225806451612903
9494	1507	29	1	0	30	1	0.03333333333333333
9495	1525	41	1	0	42	1	0.023809523809523808
9496	1551	26	1	0	27	1	0.037037037037037035
9497	1531	33	0	0	33	0	0
9498	1509	27	1	0	28	1	0.03571428571428571
9499	1503	28	2	0	30	2	0.06666666666666667
95	1480	32	1	0	33	1	0.030303030303030304
950	1538	34	0	0	34	0	0
9500	1528	31	1	0	32	1	0.03125
9501	1518	38	0	0	38	0	0
9502	1484	29	0	0	29	0	0
9503	1501	27	2	0	29	2	0.06896551724137931
9504	1509	30	0	0	30	0	0
9505	1504	25	0	0	25	0	0
9506	1500	30	1	0	31	1	0.03225806451612903
9507	1503	28	0	0	28	0	0
9508	1537	30	2	0	32	2	0.0625
9509	1560	25	0	0	25	0	0
951	1477	36	0	0	36	0	0
9510	1527	36	0	0	36	0	0
9511	1487	36	1	0	37	1	0.02702702702702703
9512	1499	27	3	0	30	3	0.1
9513	1505	23	0	0	23	0	0
9514	1516	29	0	0	29	0	0
9515	1516	31	0	0	31	0	0
9516	1536	30	1	0	31	1	0.03225806451612903
9517	1533	28	1	0	29	1	0.034482758620689655
9518	1494	34	2	0	36	2	0.05555555555555555
9519	1471	26	1	0	27	1	0.037037037037037035
952	1528	31	5	0	36	5	0.1388888888888889
9520	1501	39	1	0	40	1	0.025
9521	1495	32	0	0	32	0	0
9522	1507	34	0	0	34	0	0
9523	1502	29	1	0	30	1	0.03333333333333333
9524	1494	36	1	0	37	1	0.02702702702702703
9525	1509	32	2	0	34	2	0.058823529411764705
9526	1476	33	0	0	33	0	0
9527	1529	24	4	0	28	4	0.14285714285714285
9528	1509	29	1	0	30	1	0.03333333333333333
9529	1498	34	1	0	35	1	0.02857142857142857
953	1520	27	1	0	28	1	0.03571428571428571
9530	1509	33	0	0	33	0	0
9531	1549	28	0	0	28	0	0
9532	1492	30	2	0	32	2	0.0625
9533	1499	39	1	0	40	1	0.025
9534	1490	30	0	0	30	0	0
9535	1491	34	0	0	34	0	0
9536	1504	32	2	0	34	2	0.058823529411764705
9537	1508	28	1	0	29	1	0.034482758620689655
9538	1498	43	0	0	43	0	0
9539	1487	25	0	0	25	0	0
954	1502	27	1	1	29	2	0.06896551724137931
9540	1522	20	0	0	20	0	0
9541	1493	29	1	0	30	1	0.03333333333333333
9542	1516	31	3	0	34	3	0.08823529411764706
9543	1520	26	4	0	30	4	0.13333333333333333
9544	1558	40	4	0	44	4	0.09090909090909091
9545	1518	30	2	0	32	2	0.0625
9546	1543	31	2	0	33	2	0.06060606060606061
9547	1516	36	1	0	37	1	0.02702702702702703
9548	1515	20	2	0	22	2	0.09090909090909091
9549	1478	23	0	0	23	0	0
955	1500	28	0	0	28	0	0
9550	1495	32	0	0	32	0	0
9551	1551	29	0	0	29	0	0
9552	1512	29	1	0	30	1	0.03333333333333333
9553	1500	42	0	0	42	0	0
9554	1535	27	2	0	29	2	0.06896551724137931
9555	1534	23	0	0	23	0	0
9556	1511	35	0	0	35	0	0
9557	1486	31	2	0	33	2	0.06060606060606061
9558	1540	28	0	0	28	0	0
9559	1487	40	0	0	40	0	0
956	1495	40	1	0	41	1	0.024390243902439025
9560	1488	35	0	0	35	0	0
9561	1496	28	0	0	28	0	0
9562	1482	38	0	1	39	1	0.02564102564102564
9563	1504	36	2	0	38	2	0.05263157894736842
9564	1475	32	0	0	32	0	0
9565	1496	26	1	0	27	1	0.037037037037037035
9566	1542	31	0	0	31	0	0
9567	1500	26	0	0	26	0	0
9568	1491	38	2	0	40	2	0.05
9569	1534	38	0	0	38	0	0
957	1506	28	1	0	29	1	0.034482758620689655
9570	1512	35	3	0	38	3	0.07894736842105263
9571	1491	31	1	0	32	1	0.03125
9572	1489	40	1	0	41	1	0.024390243902439025
9573	1488	31	1	1	33	2	0.06060606060606061
9574	1475	19	2	0	21	2	0.09523809523809523
9575	1499	40	2	0	42	2	0.047619047619047616
9576	1505	35	2	0	37	2	0.05405405405405406
9577	1490	24	1	0	25	1	0.04
9578	1504	32	0	0	32	0	0
9579	1503	26	2	0	28	2	0.07142857142857142
958	1520	39	0	0	39	0	0
9580	1497	29	2	0	31	2	0.06451612903225806
9581	1511	34	1	0	35	1	0.02857142857142857
9582	1507	32	0	0	32	0	0
9583	1532	28	1	0	29	1	0.034482758620689655
9584	1511	37	3	0	40	3	0.075
9585	1485	27	2	0	29	2	0.06896551724137931
9586	1534	29	0	0	29	0	0
9587	1520	38	0	0	38	0	0
9588	1509	26	1	0	27	1	0.037037037037037035
9589	1512	28	0	0	28	0	0
959	1512	29	0	1	30	1	0.03333333333333333
9590	1517	27	1	0	28	1	0.03571428571428571
9591	1472	29	0	0	29	0	0
9592	1540	34	1	0	35	1	0.02857142857142857
9593	1508	35	0	0	35	0	0
9594	1485	41	1	0	42	1	0.023809523809523808
9595	1520	28	0	0	28	0	0
9596	1523	24	1	0	25	1	0.04
9597	1509	23	2	0	25	2	0.08
9598	1496	30	0	0	30	0	0
9599	1483	41	0	1	42	1	0.023809523809523808
96	1514	31	1	0	32	1	0.03125
960	1534	35	0	0	35	0	0
9600	1525	23	0	0	23	0	0
9601	1498	41	0	0	41	0	0
9602	1495	36	0	0	36	0	0
9603	1538	32	0	0	32	0	0
9604	1507	31	1	0	32	1	0.03125
9605	1469	29	1	0	30	1	0.03333333333333333
9606	1524	28	0	0	28	0	0
9607	1523	37	0	0	37	0	0
9608	1487	23	0	0	23	0	0
9609	1477	26	2	0	28	2	0.07142857142857142
961	1524	29	1	0	30	1	0.03333333333333333
9610	1497	39	0	0	39	0	0
9611	1504	32	1	0	33	1	0.030303030303030304
9612	1526	34	1	0	35	1	0.02857142857142857
9613	1531	30	1	0	31	1	0.03225806451612903
9614	1484	33	0	0	33	0	0
9615	1483	26	1	0	27	1	0.037037037037037035
9616	1487	40	0	0	40	0	0
9617	1520	26	1	0	27	1	0.037037037037037035
9618	1492	29	2	0	31	2	0.06451612903225806
9619	1528	33	1	0	34	1	0.029411764705882353
962	1497	31	0	0	31	0	0
9620	1519	26	0	0	26	0	0
9621	1487	35	2	0	37	2	0.05405405405405406
9622	1474	31	0	0	31	0	0
9623	1490	31	0	0	31	0	0
9624	1495	37	0	0	37	0	0
9625	1517	30	1	0	31	1	0.03225806451612903
9626	1499	25	1	0	26	1	0.038461538461538464
9627	1524	37	1	0	38	1	0.02631578947368421
9628	1481	31	0	0	31	0	0
9629	1474	28	1	0	29	1	0.034482758620689655
963	1504	32	1	0	33	1	0.030303030303030304
9630	1531	31	1	0	32	1	0.03125
9631	1527	28	0	1	29	1	0.034482758620689655
9632	1500	28	0	0	28	0	0
9633	1520	24	1	0	25	1	0.04
9634	1492	35	1	0	36	1	0.027777777777777776
9635	1505	22	2	0	24	2	0.08333333333333333
9636	1538	30	2	0	32	2	0.0625
9637	1541	29	0	0	29	0	0
9638	1511	26	0	0	26	0	0
9639	1544	26	2	0	28	2	0.07142857142857142
964	1479	33	2	0	35	2	0.05714285714285714
9640	1493	32	1	0	33	1	0.030303030303030304
9641	1490	21	1	0	22	1	0.045454545454545456
9642	1504	36	2	0	38	2	0.05263157894736842
9643	1521	36	0	0	36	0	0
9644	1520	36	2	0	38	2	0.05263157894736842
9645	1504	23	0	0	23	0	0
9646	1527	24	2	0	26	2	0.07692307692307693
9647	1505	38	0	0	38	0	0
9648	1504	36	1	0	37	1	0.02702702702702703
9649	1521	24	0	0	24	0	0
965	1521	36	1	0	37	1	0.02702702702702703
9650	1493	31	1	1	33	2	0.06060606060606061
9651	1521	31	1	0	32	1	0.03125
9652	1517	40	1	0	41	1	0.024390243902439025
9653	1499	30	0	0	30	0	0
9654	1472	30	2	0	32	2	0.0625
9655	1534	22	0	0	22	0	0
9656	1503	41	1	0	42	1	0.023809523809523808
9657	1535	34	0	0	34	0	0
9658	1509	27	1	0	28	1	0.03571428571428571
9659	1470	23	2	0	25	2	0.08
966	1481	31	0	0	31	0	0
9660	1519	32	0	0	32	0	0
9661	1504	28	0	0	28	0	0
9662	1512	34	0	0	34	0	0
9663	1494	34	1	0	35	1	0.02857142857142857
9664	1517	30	1	0	31	1	0.03225806451612903
9665	1557	25	0	0	25	0	0
9666	1498	27	2	0	29	2	0.06896551724137931
9667	1491	28	1	0	29	1	0.034482758620689655
9668	1505	24	0	0	24	0	0
9669	1496	24	1	0	25	1	0.04
967	1534	26	0	0	26	0	0
9670	1508	32	0	0	32	0	0
9671	1522	31	0	0	31	0	0
9672	1512	29	0	0	29	0	0
9673	1537	30	1	0	31	1	0.03225806451612903
9674	1491	28	1	0	29	1	0.034482758620689655
9675	1514	38	1	0	39	1	0.02564102564102564
9676	1505	37	1	0	38	1	0.02631578947368421
9677	1515	23	2	0	25	2	0.08
9678	1527	35	0	0	35	0	0
9679	1524	30	0	0	30	0	0
968	1496	25	2	0	27	2	0.07407407407407407
9680	1532	45	0	0	45	0	0
9681	1468	26	0	0	26	0	0
9682	1491	41	0	0	41	0	0
9683	1501	32	2	0	34	2	0.058823529411764705
9684	1501	40	0	0	40	0	0
9685	1522	27	1	0	28	1	0.03571428571428571
9686	1514	28	0	0	28	0	0
9687	1524	27	1	0	28	1	0.03571428571428571
9688	1518	32	0	0	32	0	0
9689	1502	28	1	0	29	1	0.034482758620689655
969	1521	38	0	0	38	0	0
9690	1521	26	0	0	26	0	0
9691	1516	37	0	0	37	0	0
9692	1515	32	0	0	32	0	0
9693	1526	27	0	0	27	0	0
9694	1532	30	1	0	31	1	0.03225806451612903
9695	1512	27	0	0	27	0	0
9696	1534	22	2	0	24	2	0.08333333333333333
9697	1550	27	0	0	27	0	0
9698	1505	25	2	0	27	2	0.07407407407407407
9699	1526	31	1	0	32	1	0.03125
97	1507	36	0	0	36	0	0
970	1526	32	0	0	32	0	0
9700	1525	29	0	0	29	0	0
9701	1490	22	1	0	23	1	0.043478260869565216
9702	1516	31	0	0	31	0	0
9703	1466	22	0	0	22	0	0
9704	1532	40	2	0	42	2	0.047619047619047616
9705	1480	32	2	0	34	2	0.058823529411764705
9706	1482	19	1	0	20	1	0.05
9707	1487	22	0	0	22	0	0
9708	1545	29	3	0	32	3	0.09375
9709	1507	30	0	0	30	0	0
971	1543	34	0	0	34	0	0
9710	1545	29	0	0	29	0	0
9711	1511	25	0	0	25	0	0
9712	1504	32	1	0	33	1	0.030303030303030304
9713	1517	34	1	0	35	1	0.02857142857142857
9714	1528	36	3	0	39	3	0.07692307692307693
9715	1528	38	1	0	39	1	0.02564102564102564
9716	1513	31	0	0	31	0	0
9717	1516	25	2	0	27	2	0.07407407407407407
9718	1512	38	1	0	39	1	0.02564102564102564
9719	1538	31	1	0	32	1	0.03125
972	1540	32	0	0	32	0	0
9720	1502	26	0	0	26	0	0
9721	1548	31	1	0	32	1	0.03125
9722	1514	36	0	0	36	0	0
9723	1502	28	1	0	29	1	0.034482758620689655
9724	1510	30	2	0	32	2	0.0625
9725	1496	37	2	0	39	2	0.05128205128205128
9726	1542	30	0	0	30	0	0
9727	1506	32	1	0	33	1	0.030303030303030304
9728	1507	37	0	0	37	0	0
9729	1515	35	1	0	36	1	0.027777777777777776
973	1506	30	1	0	31	1	0.03225806451612903
9730	1527	39	0	0	39	0	0
9731	1513	27	0	0	27	0	0
9732	1529	33	2	0	35	2	0.05714285714285714
9733	1514	27	1	0	28	1	0.03571428571428571
9734	1517	32	2	0	34	2	0.058823529411764705
9735	1516	28	1	0	29	1	0.034482758620689655
9736	1549	30	0	0	30	0	0
9737	1510	25	1	0	26	1	0.038461538461538464
9738	1504	40	2	0	42	2	0.047619047619047616
9739	1529	28	0	0	28	0	0
974	1529	34	0	0	34	0	0
9740	1515	20	0	0	20	0	0
9741	1527	38	2	0	40	2	0.05
9742	1470	30	0	0	30	0	0
9743	1504	29	2	0	31	2	0.06451612903225806
9744	1519	27	0	0	27	0	0
9745	1526	31	0	0	31	0	0
9746	1485	38	0	0	38	0	0
9747	1479	32	0	0	32	0	0
9748	1517	36	0	0	36	0	0
9749	1490	36	0	0	36	0	0
975	1528	34	0	0	34	0	0
9750	1497	32	0	0	32	0	0
9751	1513	33	0	0	33	0	0
9752	1539	35	2	0	37	2	0.05405405405405406
9753	1517	30	1	0	31	1	0.03225806451612903
9754	1491	34	0	0	34	0	0
9755	1495	30	3	0	33	3	0.09090909090909091
9756	1548	40	0	0	40	0	0
9757	1511	27	1	0	28	1	0.03571428571428571
9758	1503	36	0	0	36	0	0
9759	1506	34	3	0	37	3	0.08108108108108109
976	1509	28	1	0	29	1	0.034482758620689655
9760	1505	34	0	0	34	0	0
9761	1542	32	0	0	32	0	0
9762	1525	35	2	0	37	2	0.05405405405405406
9763	1514	25	0	0	25	0	0
9764	1517	25	1	0	26	1	0.038461538461538464
9765	1465	22	1	0	23	1	0.043478260869565216
9766	1512	34	0	0	34	0	0
9767	1538	40	0	0	40	0	0
9768	1501	39	2	0	41	2	0.04878048780487805
9769	1506	33	0	0	33	0	0
977	1539	28	1	0	29	1	0.034482758620689655
9770	1527	31	0	0	31	0	0
9771	1505	33	0	0	33	0	0
9772	1557	24	2	0	26	2	0.07692307692307693
9773	1512	43	2	0	45	2	0.044444444444444446
9774	1541	32	0	0	32	0	0
9775	1530	23	0	0	23	0	0
9776	1533	29	2	0	31	2	0.06451612903225806
9777	1506	25	0	0	25	0	0
9778	1491	28	2	0	30	2	0.06666666666666667
9779	1481	30	1	0	31	1	0.03225806451612903
978	1532	31	1	0	32	1	0.03125
9780	1495	28	0	0	28	0	0
9781	1464	31	1	0	32	1	0.03125
9782	1534	24	2	0	26	2	0.07692307692307693
9783	1524	35	1	0	36	1	0.027777777777777776
9784	1486	31	1	0	32	1	0.03125
9785	1522	26	0	0	26	0	0
9786	1436	32	1	0	33	1	0.030303030303030304
9787	1525	42	1	0	43	1	0.023255813953488372
9788	1507	30	1	0	31	1	0.03225806451612903
9789	1493	32	0	0	32	0	0
979	1551	28	1	0	29	1	0.034482758620689655
9790	1518	26	1	0	27	1	0.037037037037037035
9791	1498	38	2	0	40	2	0.05
9792	1531	18	1	0	19	1	0.05263157894736842
9793	1511	32	0	0	32	0	0
9794	1518	36	0	0	36	0	0
9795	1527	19	1	0	20	1	0.05
9796	1490	31	1	0	32	1	0.03125
9797	1502	35	0	0	35	0	0
9798	1501	24	0	0	24	0	0
9799	1526	36	0	0	36	0	0
98	1532	28	1	0	29	1	0.034482758620689655
980	1489	26	1	0	27	1	0.037037037037037035
9800	1531	30	0	0	30	0	0
9801	1517	29	2	0	31	2	0.06451612903225806
9802	1541	42	0	0	42	0	0
9803	1502	29	2	0	31	2	0.06451612903225806
9804	1526	32	1	0	33	1	0.030303030303030304
9805	1545	34	0	0	34	0	0
9806	1474	31	1	0	32	1	0.03125
9807	1517	22	1	0	23	1	0.043478260869565216
9808	1526	29	0	0	29	0	0
9809	1505	23	1	0	24	1	0.041666666666666664
981	1526	27	0	0	27	0	0
9810	1541	23	0	0	23	0	0
9811	1546	33	1	0	34	1	0.029411764705882353
9812	1514	35	1	0	36	1	0.027777777777777776
9813	1518	25	0	0	25	0	0
9814	1529	28	3	0	31	3	0.0967741935483871
9815	1514	32	2	0	34	2	0.058823529411764705
9816	1520	31	1	0	32	1	0.03125
9817	1521	23	0	0	23	0	0
9818	1552	25	4	0	29	4	0.13793103448275862
9819	1509	25	0	0	25	0	0
982	1516	28	1	0	29	1	0.034482758620689655
9820	1526	23	0	0	23	0	0
9821	1499	32	3	0	35	3	0.08571428571428572
9822	1497	26	2	0	28	2	0.07142857142857142
9823	1539	34	0	0	34	0	0
9824	1535	31	0	0	31	0	0
9825	1522	31	1	0	32	1	0.03125
9826	1482	27	1	0	28	1	0.03571428571428571
9827	1517	28	0	0	28	0	0
9828	1497	34	0	0	34	0	0
9829	1494	38	1	0	39	1	0.02564102564102564
983	1493	44	1	0	45	1	0.022222222222222223
9830	1548	19	1	0	20	1	0.05
9831	1524	32	0	0	32	0	0
9832	1520	35	2	0	37	2	0.05405405405405406
9833	1502	37	4	0	41	4	0.0975609756097561
9834	1497	32	1	0	33	1	0.030303030303030304
9835	1528	33	1	0	34	1	0.029411764705882353
9836	1524	21	0	0	21	0	0
9837	1505	34	1	0	35	1	0.02857142857142857
9838	1513	27	4	0	31	4	0.12903225806451613
9839	1546	26	1	0	27	1	0.037037037037037035
984	1507	42	0	0	42	0	0
9840	1471	36	0	0	36	0	0
9841	1525	27	1	0	28	1	0.03571428571428571
9842	1472	29	1	0	30	1	0.03333333333333333
9843	1520	32	1	0	33	1	0.030303030303030304
9844	1506	34	0	0	34	0	0
9845	1491	31	1	0	32	1	0.03125
9846	1496	42	1	0	43	1	0.023255813953488372
9847	1509	28	0	0	28	0	0
9848	1508	25	2	0	27	2	0.07407407407407407
9849	1520	20	1	1	22	2	0.09090909090909091
985	1512	44	1	0	45	1	0.022222222222222223
9850	1516	26	0	0	26	0	0
9851	1513	23	1	0	24	1	0.041666666666666664
9852	1501	24	2	0	26	2	0.07692307692307693
9853	1527	30	3	0	33	3	0.09090909090909091
9854	1510	30	0	0	30	0	0
9855	1521	29	1	0	30	1	0.03333333333333333
9856	1517	28	0	0	28	0	0
9857	1475	39	1	0	40	1	0.025
9858	1534	43	0	0	43	0	0
9859	1513	22	1	0	23	1	0.043478260869565216
986	1532	31	0	0	31	0	0
9860	1522	30	1	0	31	1	0.03225806451612903
9861	1535	35	0	0	35	0	0
9862	1479	32	0	0	32	0	0
9863	1503	23	0	0	23	0	0
9864	1490	32	0	0	32	0	0
9865	1519	32	1	0	33	1	0.030303030303030304
9866	1519	38	1	0	39	1	0.02564102564102564
9867	1526	34	2	0	36	2	0.05555555555555555
9868	1525	28	1	0	29	1	0.034482758620689655
9869	1528	27	1	0	28	1	0.03571428571428571
987	1505	29	0	0	29	0	0
9870	1504	31	2	0	33	2	0.06060606060606061
9871	1515	23	0	0	23	0	0
9872	1482	32	0	0	32	0	0
9873	1518	35	2	0	37	2	0.05405405405405406
9874	1537	35	0	0	35	0	0
9875	1528	35	3	0	38	3	0.07894736842105263
9876	1534	39	2	0	41	2	0.04878048780487805
9877	1535	24	0	0	24	0	0
9878	1493	33	2	0	35	2	0.05714285714285714
9879	1524	35	1	0	36	1	0.027777777777777776
988	1519	26	0	0	26	0	0
9880	1550	47	0	0	47	0	0
9881	1496	39	2	0	41	2	0.04878048780487805
9882	1527	23	1	0	24	1	0.041666666666666664
9883	1523	33	0	0	33	0	0
9884	1535	34	1	0	35	1	0.02857142857142857
9885	1506	34	1	0	35	1	0.02857142857142857
9886	1529	27	1	0	28	1	0.03571428571428571
9887	1534	32	1	0	33	1	0.030303030303030304
9888	1522	34	1	0	35	1	0.02857142857142857
9889	1501	31	1	0	32	1	0.03125
989	1510	31	0	0	31	0	0
9890	1481	31	1	0	32	1	0.03125
9891	1519	24	5	0	29	5	0.1724137931034483
9892	1467	36	0	0	36	0	0
9893	1483	30	2	0	32	2	0.0625
9894	1483	36	1	0	37	1	0.02702702702702703
9895	1499	29	2	0	31	2	0.06451612903225806
9896	1516	46	1	0	47	1	0.02127659574468085
9897	1501	30	1	0	31	1	0.03225806451612903
9898	1535	28	1	0	29	1	0.034482758620689655
9899	1504	23	2	0	25	2	0.08
99	1522	26	0	0	26	0	0
990	1500	33	0	0	33	0	0
9900	1515	39	1	0	40	1	0.025
9901	1444	36	0	0	36	0	0
9902	1480	27	0	0	27	0	0
9903	1505	35	0	0	35	0	0
9904	1505	40	1	0	41	1	0.024390243902439025
9905	1501	31	1	0	32	1	0.03125
9906	1526	28	4	0	32	4	0.125
9907	1515	35	2	0	37	2	0.05405405405405406
9908	1505	27	1	0	28	1	0.03571428571428571
9909	1479	33	1	0	34	1	0.029411764705882353
991	1531	27	1	0	28	1	0.03571428571428571
9910	1518	27	0	0	27	0	0
9911	1495	33	4	0	37	4	0.10810810810810811
9912	1504	35	4	0	39	4	0.10256410256410256
9913	1494	36	2	0	38	2	0.05263157894736842
9914	1507	37	0	0	37	0	0
9915	1551	37	1	0	38	1	0.02631578947368421
9916	1516	30	3	0	33	3	0.09090909090909091
9917	1519	29	3	0	32	3	0.09375
9918	1528	36	0	0	36	0	0
9919	1494	30	1	0	31	1	0.03225806451612903
992	1511	34	2	0	36	2	0.05555555555555555
9920	1496	29	0	0	29	0	0
9921	1513	30	1	0	31	1	0.03225806451612903
9922	1516	39	1	0	40	1	0.025
9923	1547	18	0	0	18	0	0
9924	1507	30	2	0	32	2	0.0625
9925	1533	24	1	0	25	1	0.04
9926	1488	50	1	0	51	1	0.0196078431372549
9927	1515	40	0	0	40	0	0
9928	1497	35	1	0	36	1	0.027777777777777776
9929	1501	26	0	0	26	0	0
993	1503	34	2	0	36	2	0.05555555555555555
9930	1518	35	2	0	37	2	0.05405405405405406
9931	1520	35	2	0	37	2	0.05405405405405406
9932	1508	35	1	0	36	1	0.027777777777777776
9933	1479	34	2	0	36	2	0.05555555555555555
9934	1532	28	1	0	29	1	0.034482758620689655
9935	1475	23	1	0	24	1	0.041666666666666664
9936	1490	24	0	0	24	0	0
9937	1535	30	2	0	32	2	0.0625
9938	1509	27	1	0	28	1	0.03571428571428571
9939	1492	31	1	0	32	1	0.03125
994	1516	36	1	0	37	1	0.02702702702702703
9940	1552	21	0	0	21	0	0
9941	1514	31	0	0	31	0	0
9942	1494	28	1	0	29	1	0.034482758620689655
9943	1505	36	0	0	36	0	0
9944	1521	27	2	0	29	2	0.06896551724137931
9945	1528	24	1	0	25	1	0.04
9946	1530	41	1	0	42	1	0.023809523809523808
9947	1508	27	1	0	28	1	0.03571428571428571
9948	1520	29	1	0	30	1	0.03333333333333333
9949	1490	23	0	0	23	0	0
995	1557	26	0	0	26	0	0
9950	1499	36	2	0	38	2	0.05263157894736842
9951	1503	27	2	0	29	2	0.06896551724137931
9952	1512	35	0	0	35	0	0
9953	1494	42	2	0	44	2	0.045454545454545456
9954	1551	31	0	0	31	0	0
9955	1496	28	1	0	29	1	0.034482758620689655
9956	1503	43	1	0	44	1	0.022727272727272728
9957	1501	33	3	0	36	3	0.08333333333333333
9958	1507	28	2	0	30	2	0.06666666666666667
9959	1529	30	2	0	32	2	0.0625
996	1496	31	1	0	32	1	0.03125
9960	1498	32	2	0	34	2	0.058823529411764705
9961	1510	23	0	0	23	0	0
9962	1485	36	1	0	37	1	0.02702702702702703
9963	1490	41	1	0	42	1	0.023809523809523808
9964	1492	23	0	0	23	0	0
9965	1492	28	2	0	30	2	0.06666666666666667
9966	1506	28	0	0	28	0	0
9967	1528	30	0	0	30	0	0
9968	1535	40	1	0	41	1	0.024390243902439025
9969	1501	31	0	0	31	0	0
997	1512	27	0	0	27	0	0
9970	1514	35	0	0	35	0	0
9971	1512	34	0	0	34	0	0
9972	1518	29	0	0	29	0	0
9973	1482	30	1	0	31	1	0.03225806451612903
9974	1523	22	1	0	23	1	0.043478260869565216
9975	1510	26	0	0	26	0	0
9976	1510	27	1	0	28	1	0.03571428571428571
9977	1516	39	0	0	39	0	0
9978	1505	26	0	0	26	0	0
9979	1532	44	2	0	46	2	0.043478260869565216
998	1537	23	0	0	23	0	0
9980	1503	32	0	0	32	0	0
9981	1516	27	1	0	28	1	0.03571428571428571
9982	1507	26	1	0	27	1	0.037037037037037035
9983	1513	31	0	0	31	0	0
9984	1484	41	0	0	41	0	0
9985	1483	24	1	0	25	1	0.04
9986	1511	31	0	0	31	0	0
9987	1513	21	0	0	21	0	0
9988	1509	37	2	0	39	2	0.05128205128205128
9989	1533	32	0	0	32	0	0
999	1514	28	2	0	30	2	0.06666666666666667
9990	1506	27	0	0	27	0	0
9991	1519	34	0	0	34	0	0
9992	1476	39	1	0	40	1	0.025
9993	1502	32	1	0	33	1	0.030303030303030304
9994	1508	38	2	0	40	2	0.05
9995	1507	37	1	0	38	1	0.02631578947368421
9996	1502	26	3	0	29	3	0.10344827586206896
9997	1516	28	1	0	29	1	0.034482758620689655
9998	1502	33	2	0	35	2	0.05714285714285714
9999	1518	36	1	0	37	1	0.02702702702702703
